form	lemma	POS	morph
Enſuyuent	ensuivre	VERcjg	MODE=ind|TEMPS=pst|PERS.=3|NOMB.=p
pluſieurs	plusieurs	DETind	NOMB.=p|GENRE=m
menus	menu	ADJqua	NOMB.=p|GENRE=m
propos	propos	NOMcom	NOMB.=p|GENRE=m
moraulx	moral	ADJqua	NOMB.=p|GENRE=m
et	et	CONcoo	MORPH=empty
ioyeulx	joyeux	ADJqua	NOMB.=p|GENRE=m
O	ô	INJ	MORPH=empty
Treſ	très	ADVgen	MORPH=empty
illuſtre	illustre	ADJqua	NOMB.=s|GENRE=m
et	et	CONcoo	MORPH=empty
hault	haut	ADJqua	NOMB.=s|GENRE=m
prince	prince	NOMcom	NOMB.=s|GENRE=m
excellent	excellent	ADJqua	NOMB.=s|GENRE=m
Triumphateur	triomphateur	NOMpro	NOMB.=s|GENRE=m
de	de	PRE	MORPH=empty
paix	paix	NOMcom	NOMB.=s|GENRE=f
beniuolent	bénévolent	ADJqua	NOMB.=s|GENRE=m
Treſobey	tresobey	NOMpro	NOMB.=s
en	en	PRE	MORPH=empty
ton	ton	DETpos	PERS.=2|NOMB.=s|GENRE=m
noble	noble	ADJqua	NOMB.=s|GENRE=m
dommaine	domaine	NOMcom	NOMB.=s|GENRE=m
Anthoine	Antoine	NOMpro	NOMB.=s|GENRE=m
duc	duc	NOMcom	NOMB.=s|GENRE=m
de	de	PRE	MORPH=empty
Calabre	Calabre	NOMpro	NOMB.=s|GENRE=f
et	et	CONcoo	MORPH=empty
Lorraine	Lorraine	NOMpro	NOMB.=s|GENRE=f
Auſſi	aussi	ADVgen	MORPH=empty
de	de	PRE	MORPH=empty
Bar	Bar	NOMpro	NOMB.=s|GENRE=x
marchis	marquis	NOMcom	NOMB.=s|GENRE=m
marquis	marquis	NOMcom	NOMB.=s|GENRE=m
du	de_le	PRE.DETdef	NOMB.=s|GENRE=m
Pont	Pont	NOMpro	NOMB.=s|GENRE=m
Et	et	CONcoo	MORPH=empty
de	de	PRE	MORPH=empty
Prouence	Provence	NOMpro	NOMB.=s|GENRE=f
auecques	avec	PRE	MORPH=empty
Vaudemont	Vaudémont	NOMpro	NOMB.=s|GENRE=x
Conte	conte	NOMcom	NOMB.=s|GENRE=m
et	et	CONcoo	MORPH=empty
ſeigneur	seigneur	NOMcom	NOMB.=s|GENRE=m
prens	prendre	VERcjg	MODE=imp|PERS.=2|NOMB.=s
en	en	PRE	MORPH=empty
gre	gré	NOMcom	NOMB.=s|GENRE=m
ceſte	ce	DETdem	NOMB.=s|GENRE=f
hyſtoire	histoire	NOMcom	NOMB.=s|GENRE=f
De	de	PRE	MORPH=empty
ton	ton	DETpos	PERS.=2|NOMB.=s|GENRE=m
herault	héraut	NOMcom	NOMB.=s|GENRE=m
nomme	nommer	VERppe	NOMB.=s|GENRE=m
Pierre	Pierre	NOMpro	NOMB.=s|GENRE=m
Gringoire	Gringoire	NOMpro	NOMB.=s|GENRE=x
Dit	dire	VERppe	NOMB.=s|GENRE=m
Vaudemont	Vaudémont	NOMpro	NOMB.=s|GENRE=x
petit	petit	ADJqua	NOMB.=s|GENRE=m
preſent	présent	NOMcom	NOMB.=s|GENRE=m
te	tu	PROper	PERS.=2|NOMB.=s|GENRE=x|CAS=r
faict	faire	VERinf	MODE=ind|TEMPS=pst|PERS.=3|NOMB.=s
Conſiderant	considérer	VERppa	NOMB.=s|GENRE=m
quil	que_il	CONsub.PROper	PERS.=3|NOMB.=s|GENRE=m|CAS=n
n	ne	ADVneg	MORPH=empty
eſt	être	VERcjg	MODE=ind|TEMPS=pst|PERS.=3|NOMB.=s
homme	homme	NOMcom	NOMB.=s|GENRE=m
parfaict	parfait	ADJqua	NOMB.=s|GENRE=m
C			
eſt	être	VERcjg	MODE=ind|TEMPS=pst|PERS.=3|NOMB.=s
ingere	ingérer	VERppe	NOMB.=s|GENRE=m
d	de	PRE	MORPH=empty
ung	un	DETndf	NOMB.=s|GENRE=m
treſardant	trèsardant	ADJqua	NOMB.=s|GENRE=m
couraige	courage	NOMcom	NOMB.=s|GENRE=m
De	de	PRE	MORPH=empty
compoſer	composer	VERinf	MORPH=empty
ceſtuy	ce	DETdem	NOMB.=s|GENRE=m
petit	petit	ADJqua	NOMB.=s|GENRE=m
ouuraige	ouvrage	NOMcom	NOMB.=s|GENRE=m
Intitule	intituler	VERppe	NOMB.=s|GENRE=m
pluſieurs	plusieurs	DETind	NOMB.=p|GENRE=m
menus	menu	ADJqua	NOMB.=p|GENRE=m
propos	propos	NOMcom	NOMB.=p|GENRE=m
Mieulx	mieux	ADVgen	MORPH=empty
uault	valoir	VERcjg	MODE=ind|TEMPS=pst|PERS.=3|NOMB.=s
ueiller	veiller	VERinf	MORPH=empty
que	que	CONsub	MORPH=empty
prendre	prendre	VERinf	MORPH=empty
long	long	ADJqua	NOMB.=s|GENRE=m
repos	repos	NOMcom	NOMB.=s|GENRE=m
Pource	pour_ce	ADVgen	MORPH=empty
que	que	CONsub	MORPH=empty
aucuns	aucun	PROind	NOMB.=p|GENRE=m
figurent	figurer	VERcjg	MODE=ind|TEMPS=pst|PERS.=3|NOMB.=p
ariſtote	Aristote	NOMpro	NOMB.=s|GENRE=m
A	à	PRE	MORPH=empty
quatre	quatre	DETcar	NOMB.=p|GENRE=m
pieds	pied	NOMcom	NOMB.=p|GENRE=m
et	et	CONcoo	MORPH=empty
une	un	DETndf	NOMB.=s|GENRE=f
femme	femme	NOMcom	NOMB.=s|GENRE=f
ſotte	sot	ADJqua	NOMB.=s|GENRE=f
Sur	sur	PRE	MORPH=empty
icelluy	icelui	DETdem	NOMB.=s|GENRE=m
faignant	feindre	VERppa	NOMB.=p|GENRE=m
la	il	PROper	PERS.=3|NOMB.=s|GENRE=f|CAS=r
cheuaucher	chevaucher	VERinf	MORPH=empty
Vng	un	ADJqua	NOMB.=s|GENRE=m
uiateur	viateur	NOMcom	NOMB.=s|GENRE=m
mon	mon	DETpos	PERS.=1|NOMB.=s|GENRE=m
grant	grand	ADJqua	NOMB.=s|GENRE=m
amy	ami	NOMcom	NOMB.=s|GENRE=m
treſcher	très_cher	ADJqua	NOMB.=s|GENRE=m
M	je	PROper	PERS.=1|NOMB.=s|GENRE=x|CAS=r
a	avoir	VERcjg	MODE=ind|TEMPS=pst|PERS.=3|NOMB.=s
ſupplie	supplier	VERppe	NOMB.=s|GENRE=m
que	que	CONsub	MORPH=empty
vers	vers	NOMcom	NOMB.=p|GENRE=m
mondains	mondain	ADJqua	NOMB.=p|GENRE=m
procure	procurer	VERcjg	MODE=sub|TEMPS=pst|PERS.=1|NOMB.=s
Si	si	CONsub	MORPH=empty
poſſible	possible	ADJqua	NOMB.=s|GENRE=n
eſt	être	VERcjg	MODE=ind|TEMPS=pst|PERS.=3|NOMB.=s
luy	il	PROper	PERS.=3|NOMB.=s|GENRE=m|CAS=i
oſter	ôter	VERinf	MORPH=empty
ceſte	ce	DETdem	NOMB.=s|GENRE=f
iniure	injure	NOMcom	NOMB.=s|GENRE=f
Veu	voir	VERppe	NOMB.=s|GENRE=n
que	que	CONsub	MORPH=empty
ung	un	DETndf	NOMB.=s|GENRE=m
tel	tel	ADJind	NOMB.=s|GENRE=m
homme	homme	NOMcom	NOMB.=s|GENRE=m
en	en	PRE	MORPH=empty
ſcience	science	NOMcom	NOMB.=s|GENRE=f
parfaict	parfait	ADJqua	NOMB.=s|GENRE=m
Ne	ne	ADVneg	MORPH=empty
permiſt	permettre	VERcjg	MODE=ind|TEMPS=psp|PERS.=3|NOMB.=s
onc	onques	ADVgen	MORPH=empty
commettre	commettre	VERinf	MORPH=empty
ung	un	DETndf	NOMB.=s|GENRE=m
laſche	lâche	ADJqua	NOMB.=s|GENRE=m
faict	fait	NOMcom	NOMB.=s|GENRE=m
Philoſophie	philosophie	NOMcom	NOMB.=s|GENRE=f
auoit	avoir	VERcjg	MODE=ind|TEMPS=ipf|PERS.=3|NOMB.=s
en	en	PRE	MORPH=empty
ſoy	il	PROper	PERS.=3|NOMB.=s|GENRE=f|CAS=i
moralle	moral	NOMcom	NOMB.=s|GENRE=f
En	en	PRE	MORPH=empty
expoſant	exposer	VERppa	NOMB.=s|GENRE=f
auſſi	aussi	ADVgen	MORPH=empty
la	le	DETdef	NOMB.=s|GENRE=f
naturalle	naturelle	NOMcom	NOMB.=s|GENRE=f
Parquoy	par_quoi	PRE.PROrel	NOMB.=s|GENRE=n
l	le	DETdef	NOMB.=s|GENRE=n
on	on	PROper	PERS.=3|NOMB.=s|GENRE=x|CAS=n
doit	devoir	VERcjg	MODE=ind|TEMPS=pst|PERS.=3|NOMB.=s
mettre	mettre	VERinf	MORPH=empty
ſur	sur	PRE	MORPH=empty
luy	il	PROper	PERS.=3|NOMB.=s|GENRE=m|CAS=i
raiſon	raison	NOMcom	NOMB.=s|GENRE=f
Comme	comme	CONsub	MORPH=empty
voyez	voir	VERcjg	MODE=ind|TEMPS=pst|PERS.=2|NOMB.=p
,	,	PONfbl	MORPH=empty
car	car	CONcoo	MORPH=empty
c	ce	DETdem	NOMB.=s|GENRE=n
eſt	être	VERcjg	MODE=ind|TEMPS=pst|PERS.=3|NOMB.=s
ſon	son	DETpos	PERS.=3|NOMB.=s|GENRE=m
droit	droit	ADJqua	NOMB.=s|GENRE=m
blaſon	blason	NOMcom	NOMB.=s|GENRE=m
⁋	à	CONcoo	MORPH=empty
Raiſon	raison	NOMcom	NOMB.=s|GENRE=f
deſſus	dessus	PRE	MORPH=empty
la	le	DETdef	NOMB.=s|GENRE=f
figure	figure	NOMcom	NOMB.=s|GENRE=f
de	de	PRE	MORPH=empty
Aristote	Aristote	NOMpro	NOMB.=s|GENRE=m
RAiſon	raison	NOMcom	NOMB.=s|GENRE=f
ſuis	être	VERcjg	MODE=ind|TEMPS=pst|PERS.=1|NOMB.=s
ſubtile	subtil	ADJqua	NOMB.=s|GENRE=f
et	et	CONcoo	MORPH=empty
argute	argut	ADJqua	NOMB.=s|GENRE=f
Qui	qui	PROrel	NOMB.=s|GENRE=f
du	de_le	PRE.DETdef	NOMB.=s|GENRE=m
faulx	faux	NOMcom	NOMB.=s|GENRE=m
et	et	CONcoo	MORPH=empty
du	de_le	PRE.DETdef	NOMB.=s|GENRE=m
vray	vrai	NOMcom	NOMB.=s|GENRE=m
diſpute	dispute	VERcjg	MODE=ind|TEMPS=pst|PERS.=1|NOMB.=s
Affin	afin	ADVgen	MORPH=empty
de	de	PRE	MORPH=empty
bien	bien	ADVgen	MORPH=empty
et	et	CONcoo	MORPH=empty
clerement	clairement	ADVgen	MORPH=empty
Appliquer	appliquer	VERinf	MORPH=empty
tout	tout	ADJind	NOMB.=s|GENRE=m
predicament	prédicament	NOMcom	NOMB.=s|GENRE=m
Et	et	CONcoo	MORPH=empty
determiner	déterminer	VERinf	MORPH=empty
des	de_le	PRE.DETdef	NOMB.=p|GENRE=m
ſecretz	secret	NOMcom	NOMB.=p|GENRE=m
De	de	PRE	MORPH=empty
droitz	droit	NOMcom	NOMB.=p|GENRE=m
mundiaulx	mondial	ADJqua	NOMB.=p|GENRE=m
et	et	CONcoo	MORPH=empty
decretz	décret	NOMcom	NOMB.=p|GENRE=m
Et	et	CONcoo	MORPH=empty
reprimer	réprimer	VERinf	MORPH=empty
toutes	tout	DETind	NOMB.=p|GENRE=f
iniures	injure	NOMcom	NOMB.=p|GENRE=f
Les	le	DETdef	NOMB.=p|GENRE=m
faulx	faux	ADJqua	NOMB.=p|GENRE=m
poix	poids	NOMcom	NOMB.=s|GENRE=m
et	et	CONcoo	MORPH=empty
faulces	faux	ADJqua	NOMB.=p|GENRE=f
meſures	mesure	NOMcom	NOMB.=p|GENRE=f
Quietement	quiètement	ADVgen	MORPH=empty
proſperera	prospérer	VERcjg	MODE=ind|TEMPS=fut|PERS.=3|NOMB.=s
Qui	qui	PROrel	NOMB.=s|GENRE=x
par	par	PRE	MORPH=empty
moy	je	PROper	PERS.=1|NOMB.=s|GENRE=x|CAS=i
ſe	il	PROper	PERS.=3|NOMB.=s|GENRE=x|CAS=r
gouuernera	gouverner	VERcjg	MODE=ind|TEMPS=fut|PERS.=3|NOMB.=s
L	le	DETdef	NOMB.=s|GENRE=m
acteur	acteur	NOMcom	NOMB.=s|GENRE=m
.	.	PONfrt	MORPH=empty
Pere	père	NOMcom	NOMB.=s|GENRE=m
Ariſtote	Aristote	NOMpro	NOMB.=s|GENRE=m
en	en	PRE	MORPH=empty
la	le	DETdef	NOMB.=s|GENRE=f
philoſophie	philosophie	NOMcom	NOMB.=s|GENRE=f
Et	et	CONcoo	MORPH=empty
de	de	PRE	MORPH=empty
tous	tout	DETind	NOMB.=p|GENRE=m
ars	art	NOMcom	NOMB.=p|GENRE=m
et	et	CONcoo	MORPH=empty
naturelle	naturel	ADJqua	NOMB.=s|GENRE=f
vie	vie	NOMcom	NOMB.=s|GENRE=f
En	en	PRE	MORPH=empty
tous	tout	DETind	NOMB.=p|GENRE=m
ſes	son	ADJpos	NOMB.=p|GENRE=m
faitz	fait	NOMcom	NOMB.=p|GENRE=m
ſe	il	PROper	PERS.=3|NOMB.=s|GENRE=x|CAS=r
ſubmiſt	soumettre	VERcjg	MODE=ind|TEMPS=psp|PERS.=3|NOMB.=s
a	à	PRE	MORPH=empty
raiſon	raison	NOMcom	NOMB.=s|GENRE=f
Parquoy	par_quoi	PRE.PROrel	NOMB.=s|GENRE=n
ſcient	scier	VERppa	NOMB.=s|GENRE=m
fut	être	VERcjg	MODE=ind|TEMPS=psp|PERS.=3|NOMB.=s
ſans	sans	PRE	MORPH=empty
comparaiſon	comparaison	NOMcom	NOMB.=s|GENRE=f
Car	car	CONcoo	MORPH=empty
par	par	PRE	MORPH=empty
icelle	icelui	PROdem	NOMB.=s|GENRE=f
enquerant	enquérir	VERppa	NOMB.=s|GENRE=f
verite	vérité	NOMcom	NOMB.=s|GENRE=f
Magnifia	magnifier	VERcjg	MODE=ind|TEMPS=psp|PERS.=3|NOMB.=s
uertus	vertu	NOMcom	NOMB.=p|GENRE=f
et	et	CONcoo	MORPH=empty
equite	équité	NOMcom	NOMB.=s|GENRE=f
Et	et	CONcoo	MORPH=empty
doit	devoir	VERcjg	MODE=ind|TEMPS=pst|PERS.=3|NOMB.=s
marcher	marcher	VERinf	MORPH=empty
ſur	sur	PRE	MORPH=empty
l	le	DETdef	NOMB.=s|GENRE=m
homme	homme	NOMcom	NOMB.=s|GENRE=m
et	et	CONcoo	MORPH=empty
le	il	PROper	PERS.=3|NOMB.=s|GENRE=m|CAS=r
garder	garder	VERinf	MORPH=empty
De	de	PRE	MORPH=empty
trop	trop	ADVgen	MORPH=empty
menger	manger	VERinf	MORPH=empty
,	,	PONfbl	MORPH=empty
parler	parler	VERinf	MORPH=empty
et	et	CONcoo	MORPH=empty
brocarder	brocarder	VERinf	MORPH=empty
Et	et	CONcoo	MORPH=empty
refrener	réfréner	VERinf	MORPH=empty
ſa	son	DETpos	PERS.=3|NOMB.=s|GENRE=f
voulente	volonté	NOMcom	NOMB.=s|GENRE=f
mobille	mobile	ADJqua	NOMB.=s|GENRE=f
De	de	PRE	MORPH=empty
fouruoyer	fourvoyer	VERinf	MORPH=empty
aux	à_le	PRE.DETdef	NOMB.=p|GENRE=m
champs	champ	NOMcom	NOMB.=p|GENRE=m
et	et	CONcoo	MORPH=empty
a	à	PRE	MORPH=empty
la	le	DETdef	NOMB.=s|GENRE=f
ville	ville	NOMcom	NOMB.=s|GENRE=f
Pour	pour	PRE	MORPH=empty
non	non	ADVneg	MORPH=empty
tumber	tomber	VERinf	MORPH=empty
au	à_le	PRE.DETdef	NOMB.=s|GENRE=m
dãger	danger	NOMcom	NOMB.=s|GENRE=m
des	de_le	PRE.DETdef	NOMB.=p|GENRE=m
brigans	brigand	NOMcom	NOMB.=p|GENRE=m
Tenebreux	ténébreux	ADJqua	NOMB.=p|GENRE=m
lieux	lieu	NOMcom	NOMB.=p|GENRE=m
du	de_le	PRE.DETdef	NOMB.=s|GENRE=m
monde	monde	NOMcom	NOMB.=s|GENRE=m
latitans	latiter	VERppa	NOMB.=p|GENRE=m
Raiſon	raison	NOMcom	NOMB.=s|GENRE=f
par	par	PRE	MORPH=empty
tout	tout	PROind	NOMB.=s|GENRE=n
Cronique	chronique	NOMcom	NOMB.=s|GENRE=f
du	de_le	PRE.DETdef	NOMB.=s|GENRE=m
temps	temps	NOMcom	NOMB.=s|GENRE=m
preſent	présent	ADJqua	NOMB.=s|GENRE=m
L	le	DETdef	NOMB.=s|GENRE=m
An	an	NOMcom	NOMB.=s|GENRE=m
mil	mille	ADJcar	NOMB.=s|GENRE=m
cinq	cinq	DEtcar	NOMB.=p|GENRE=m
cens	cent	NOMcom	NOMB.=p|GENRE=m
uingt	vingt	ADJcar	NOMB.=s|GENRE=m
et	et	CONcoo	MORPH=empty
ung	un	ADJcar	NOMB.=s|GENRE=m
paix	paix	NOMcom	NOMB.=s|GENRE=f
regna	régner	VERcjg	MODE=ind|TEMPS=psp|PERS.=3|NOMB.=s
Dont	dont	PROrel	NOMB.=s|GENRE=n
le	le	DETdef	NOMB.=s|GENRE=m
dieu	dieu	NOMcom	NOMB.=s|GENRE=m
mars	Mars	NOMpro	NOMB.=s|GENRE=m
ſi	si	ADVgen	MORPH=empty
treſfort	très_fort	ADVgen	MORPH=empty
ſe	il	PROper	PERS.=3|NOMB.=s|GENRE=m|CAS=r
indigna	indigner	VERcjg	MODE=ind|TEMPS=psp|PERS.=3|NOMB.=s
Quil	que_il	CONsub.PROper	PERS.=3|NOMB.=s|GENRE=m|CAS=n
deſploya	déployer	VERcjg	MODE=ind|TEMPS=psp|PERS.=3|NOMB.=s
l	le	DETdef	NOMB.=s|GENRE=m
eſtandard	étendard	NOMcom	NOMB.=s|GENRE=m
de	de	PRE	MORPH=empty
follie	folie	NOMcom	NOMB.=s|GENRE=f
Dont	dont	PROrel	NOMB.=s|GENRE=m
fiſt	faire	VERcjg	MODE=ind|TEMPS=psp|PERS.=3|NOMB.=s
preſent	présent	NOMcom	NOMB.=s|GENRE=m
,	,	PONfbl	MORPH=empty
par	par	PRE	MORPH=empty
rigueur	rigueur	NOMcom	NOMB.=s|GENRE=f
le	il	PROper	PERS.=3|NOMB.=s|GENRE=m|CAS=r
donna	donner	VERcjg	MODE=ind|TEMPS=psp|PERS.=3|NOMB.=s
A	à	PRE	MORPH=empty
ſes	son	DETpos	PERS.=3|NOMB.=p|GENRE=m
enſans	enfant	NOMcom	NOMB.=p|GENRE=m
:	:	PONfbl	MORPH=empty
auſquelz	à_lequel	PRE.PROrel	NOMB.=p|GENRE=m
il	il	PROper	PERS.=3|NOMB.=s|GENRE=m|CAS=n
ordonna	ordonner	VERcjg	MODE=ind|TEMPS=psp|PERS.=3|NOMB.=s
De	de	PRE	MORPH=empty
mettre	mettre	VERinf	MORPH=empty
a	à	PRE	MORPH=empty
mort	mort	NOMcom	NOMB.=s|GENRE=f
paix	paix	NOMcom	NOMB.=s|GENRE=f
qui	qui	PROrel	NOMB.=s|GENRE=f
princes	prince	NOMcom	NOMB.=p|GENRE=m
allie	allier	VERppe	NOMB.=p|GENRE=m
Quant	quand	CONsub	MORPH=empty
paix	paix	NOMcom	NOMB.=s|GENRE=f
le	il	PROper	PERS.=3|NOMB.=s|GENRE=n|CAS=r
ſceut	savoir	VERcjg	MODE=ind|TEMPS=psp|PERS.=3|NOMB.=s
de	de	PRE	MORPH=empty
France	France	NOMpro	NOMB.=s|GENRE=f
fiſt	faire	VERcjg	MODE=ind|TEMPS=psp|PERS.=3|NOMB.=s
ſaillie	saillie	NOMcom	NOMB.=s|GENRE=f
Et	et	CONcoo	MORPH=empty
d	de	PRE	MORPH=empty
allemaigne	Allemagne	NOMpro	NOMB.=s|GENRE=f
eut	avoir	VERcjg	MODE=ind|TEMPS=psp|PERS.=3|NOMB.=s
ſa	son	DETpos	PERS.=3|NOMB.=s|GENRE=f
place	place	NOMcom	NOMB.=s|GENRE=f
en	en	PRE	MORPH=empty
Lorraine	Lorraine	NOMpro	NOMB.=s|GENRE=f
Dieu	Dieu	NOMpro	NOMB.=s|GENRE=m
moyennant	moyenner	VERppa	NOMB.=s|GENRE=f
,	,	PONfbl	MORPH=empty
et	et	CONcoo	MORPH=empty
le	le	DETdef	NOMB.=s|GENRE=m
bon	bon	ADJqua	NOMB.=s|GENRE=m
duc	duc	NOMcom	NOMB.=s|GENRE=m
Anthoine	Antoine	NOMpro	NOMB.=s|GENRE=m
.	.	PONfrt	MORPH=empty
En	en	PRE	MORPH=empty
ce	ce	DEtdem	NOMB.=s|GENRE=m
dit	dire	VERppe	NOMB.=s|GENRE=m
an	an	NOMcom	NOMB.=s|GENRE=m
il	il	PROimp	PERS.=0|NOMB.=s|GENRE=n|CAS=n
y	y	PROadv	MORPH=empty
eut	avoir	VERcjg	MODE=ind|TEMPS=psp|PERS.=3|NOMB.=s
deux	deux	DETcar	NOMB.=p|GENRE=m
ſouldare	soudard	NOMcom	NOMB.=p|GENRE=m
Qui	qui	PROrel	NOMB.=p|GENRE=m
mirent	mettre	VERcjg	MODE=ind|TEMPS=psp|PERS.=3|NOMB.=p
ſus	sus	PRE	MORPH=empty
guidons	guidon	NOMcom	NOMB.=p|GENRE=m
et	et	CONcoo	MORPH=empty
eſtandare	étendard	NOMcom	NOMB.=p|GENRE=m
En	en	PRE	MORPH=empty
eſmouuant	émouvoir	VERppa	NOMB.=p|GENRE=m
une	un	DETndf	NOMB.=s|GENRE=f
folle	fou	ADJqua	NOMB.=s|GENRE=f
querelle	querelle	NOMcom	NOMB.=s|GENRE=f
A	à	PRE	MORPH=empty
lors	lors	ADVgen	MORPH=empty
diſcorde	discorde	NOMcom	NOMB.=s|GENRE=f
empoigna	empoigner	VERcjg	MODE=ind|TEMPS=psp|PERS.=3|NOMB.=s
lance	lance	NOMcom	NOMB.=s|GENRE=f
et	et	CONcoo	MORPH=empty
dars	dard	NOMcom	NOMB.=p|GENRE=m
Les	il	PROper	PERS.=3|NOMB.=p|GENRE=x|CAS=r
pouruoyant	pourvoir	VERppa	NOMB.=s|GENRE=f
de	de	PRE	MORPH=empty
picques	pique	NOMcom	NOMB.=p|GENRE=m
auſſi	aussi	ADVgen	MORPH=empty
de	de	PRE	MORPH=empty
arcs	arc	NOMcom	NOMB.=p|GENRE=m
Dont	dont	PROrel	NOMB.=p|GENRE=m
fit	faire	VERcjg	MODE=ind|TEMPS=psp|PERS.=3|NOMB.=s
preſens	présent	NOMcom	NOMB.=p|GENRE=m
a	à	PRE	MORPH=empty
gens	gens	NOMcom	NOMB.=p|GENRE=m
pareilz	pareil	ADJqua	NOMB.=p|GENRE=m
a	à	PRE	MORPH=empty
elle	il	PROper	PERS.=3|NOMB.=s|GENRE=f|CAS=n
Ainſi	ainsi	ADVgen	MORPH=empty
ſe	il	PROper	PERS.=3|NOMB.=s|GENRE=f|CAS=r
eſmeut	émouvoir	VERppe	NOMB.=s|GENRE=f
guerre	guerre	NOMcom	NOMB.=s|GENRE=f
non	non	ADVneg	MORPH=empty
trop	trop	ADVgen	MORPH=empty
cruelle	cruel	ADJqua	NOMB.=s|GENRE=f
Car	car	CONcoo	MORPH=empty
ſe	il	PROper	PERS.=3|NOMB.=s|GENRE=f|CAS=r
n	ne	ADVneg	MORPH=empty
eſtoit	être	VERcjg	MODE=ind|TEMPS=ipf|PERS.=3|NOMB.=s
que	que	CONsub	MORPH=empty
pour	pour	PRE	MORPH=empty
ung	un	DETndf	NOMB.=s|GENRE=m
uireton	vireton	NOMcom	NOMB.=s|GENRE=m
Maint	maint	ADVgen	MORPH=empty
eſt	être	VERcjg	MODE=ind|TEMPS=pst|PERS.=3|NOMB.=s
batu	battre	VERppe	NOMB.=s|GENRE=m
de	de	PRE	MORPH=empty
ſon	son	DETpos	PERS.=3|NOMB.=s|GENRE=m
propre	propre	ADJqua	NOMB.=s|GENRE=m
baſton	bâton	NOMcom	NOMB.=s|GENRE=m
.	.	PONfrt	MORPH=empty
Oi	di	CONcoo	MORPH=empty
aduint	advenir	VERcjg	MODE=ind|TEMPS=psp|PERS.=3|NOMB.=s
il	il	PROimp	PERS.=0|NOMB.=s|GENRE=n|CAS=n
que	que	CONsub	MORPH=empty
ſoubz	sous	PRE	MORPH=empty
umbre	ombre	NOMcom	NOMB.=s|GENRE=f
de	de	PRE	MORPH=empty
bien	bien	NOMcom	NOMB.=s|GENRE=m
L	le	DETdef	NOMB.=s|GENRE=m
aigle	aigle	NOMcom	NOMB.=s|GENRE=m
uolla	voler	VERcjg	MODE=ind|TEMPS=psp|PERS.=3|NOMB.=s
diſant	dire	VERppa	NOMB.=s|GENRE=m
trouuer	trouver	VERinf	MORPH=empty
moyen	moyen	NOMcom	NOMB.=s|GENRE=m
De	de	PRE	MORPH=empty
briſer	briser	VERinf	MORPH=empty
,	,	PONfbl	MORPH=empty
rompre	rompre	VERinf	MORPH=empty
,	,	PONfbl	MORPH=empty
abolir	abolir	VERinf	MORPH=empty
et	et	CONcoo	MORPH=empty
deſtruire	détruire	VERinf	MORPH=empty
Lieux	lieu	NOMcom	NOMB.=p|GENRE=m
larcineux	larcineux	ADJqua	NOMB.=p|GENRE=m
et	et	CONcoo	MORPH=empty
n	ne	ADVneg	MORPH=empty
y	y	PROadv	MORPH=empty
eſpargnoit	épargner	VERcjg	MODE=ind|TEMPS=ipf|PERS.=3|NOMB.=s
rien	rien	PROind	NOMB.=s|GENRE=n
Tant	tant	ADVgen	MORPH=empty
que	que	CONsub	MORPH=empty
on	on	PROper	PERS.=3|NOMB.=s|GENRE=x|CAS=n
diſoit	dire	VERcjg	MODE=ind|TEMPS=ipf|PERS.=3|NOMB.=s
que	que	CONsub	MORPH=empty
per	@unknown	OUT	MORPH=empty
le	le	DETdef	NOMB.=s|GENRE=m
terrien	terrien	NOMcom	NOMB.=s|GENRE=m
Seroit	être	VERcjg	MODE=con|PERS.=3|NOMB.=s
tenu	tenir	VERppe	NOMB.=s|GENRE=m
deſſoubz	dessous	PRE	MORPH=empty
luy	il	PROper	PERS.=3|NOMB.=s|GENRE=m|CAS=i
ſe	il	PROper	PERS.=3|NOMB.=s|GENRE=x|CAS=r
reduyre	réduire	VERinf	MORPH=empty
Veu	voir	VERppe	NOMB.=s|GENRE=m
quil	que_il	CONsubPROper	PERS.=3|NOMB.=s|GENRE=m|CAS=r
prenoit	prendre	VERcjg	MODE=ind|TEMPS=ipf|PERS.=3|NOMB.=s
plaiſir	plaisir	NOMcom	NOMB.=s|GENRE=m
a	à	PRE	MORPH=empty
ſoy	il	PROper	PERS.=3|NOMB.=s|GENRE=m|CAS=r
deduyre	déduire	VERinf	MORPH=empty
Que	que	CONsub	MORPH=empty
marchandiſe	marchandise	NOMcom	NOMB.=s|GENRE=f
allaſt	aller	VERcjg	MODE=ind|TEMPS=psp|PERS.=3|NOMB.=s
par	par	PRE	MORPH=empty
le	le	DETdef	NOMB.=s|GENRE=m
chemin	chemin	NOMcom	NOMB.=s|GENRE=m
Bien	bien	ADVgen	MORPH=empty
cõmencer	commencer	VERinf	MORPH=empty
uault	valoir	VERcjg	MODE=ind|TEMPS=pst|PERS.=3|NOMB.=s
peu	peu	ADVgen	MORPH=empty
ſans	sans	PRE	MORPH=empty
bonne	bon	ADJqua	NOMB.=s|GENRE=f
fin	fin	NOMcom	NOMB.=s|GENRE=f
Lyon	lion	NOMcom	NOMB.=s|GENRE=m
de	de	PRE	MORPH=empty
ſable	sable	NOMcom	NOMB.=s|GENRE=m
eſtant	être	VERppa	NOMB.=s|GENRE=m
a	à	PRE	MORPH=empty
l	le	DETdef	NOMB.=s|GENRE=m
aigle	aigle	NOMcom	NOMB.=s|GENRE=m
uny	unir	VERppe	NOMB.=s|GENRE=m
Nourrir	nourrir	VERinf	MORPH=empty
amour	amour	NOMcom	NOMB.=s|GENRE=m
entre	entre	PRE	MORPH=empty
eulx	il	PROper	PERS.=3|NOMB.=p|GENRE=m|CAS=r
et	et	CONcoo	MORPH=empty
publier	publier	VERinf	MORPH=empty
Guerre	guerre	NOMcom	NOMB.=s|GENRE=f
et	et	CONcoo	MORPH=empty
debatz	débat	NOMcom	NOMB.=p|GENRE=m
deſſoubz	dessous	PRE	MORPH=empty
le	le	DETdef	NOMB.=s|GENRE=m
pied	pied	NOMcom	NOMB.=s|GENRE=m
plier	plier	VERinf	MORPH=empty
Oſtant	ôter	VERppa	NOMB.=s|GENRE=m
flateurs	flatteur	NOMcom	NOMB.=p|GENRE=m
de	de	PRE	MORPH=empty
aupres	auprès	ADVgen	MORPH=empty
ď	de	PRE	MORPH=empty
leur	leur	DETpos	PERS.=3|NOMB.=s|GENRE=f
perſõne	personne	NOMcom	NOMB.=s|GENRE=f
Recognoiſſant	reconnaître	VERppa	NOMB.=s|GENRE=x
que	que	CONsub	MORPH=empty
dieu	Dieu	NOMpro	NOMB.=s|GENRE=m
uictoire	victoire	NOMcom	NOMB.=s|GENRE=f
donne	donner	VERcjg	MODE=ind|TEMPS=pst|PERS.=3|NOMB.=s
Et	et	CONcoo	MORPH=empty
gloire	gloire	NOMcom	NOMB.=s|GENRE=f
auſſi	aussi	ADVgen	MORPH=empty
ce	ce	PROdem	NOMB.=s|GENRE=n
ne	ne	ADVneg	MORPH=empty
fault	falloir	VERcjg	MODE=ind|TEMPS=pst|PERS.=3|NOMB.=s
oublier	oublier	VERinf	MORPH=empty
.	.	PONfrt	MORPH=empty
Rondeau	rondeau	NOMcom	NOMB.=s|GENRE=m
Sainct	saint	ADJqua	NOMB.=s|GENRE=m
Pierre	Pierre	NOMpro	NOMB.=s|GENRE=m
print	prendre	VERcjg	MODE=ind|TEMPS=psp|PERS.=3|NOMB.=s
le	le	DETdef	NOMB.=s|GENRE=m
glaiue	glaive	NOMcom	NOMB.=s|GENRE=m
de	de	PRE	MORPH=empty
ſainct	saint	ADJqua	NOMB.=s|GENRE=m
Pol	Paul	NOMpro	NOMB.=s|GENRE=m
Dont	dont	PROrel	NOMB.=s|GENRE=m
de	de	PRE	MORPH=empty
rechief	rechef	NOMcom	NOMB.=s|GENRE=m
cuyda	cuider	VERcjg	MODE=ind|TEMPS=psp|PERS.=3|NOMB.=s
coupper	couper	VERinf	MORPH=empty
le	le	DETdef	NOMB.=s|GENRE=m
col	col	NOMcom	NOMB.=s|GENRE=m
A	à	PRE	MORPH=empty
ſainct	saint	ADJqua	NOMB.=s|GENRE=m
Denys	Denis	NOMcom	NOMB.=s|GENRE=m
,	,	PONfbl	MORPH=empty
car	car	CONcoo	MORPH=empty
ſainct	saint	ADJqua	NOMB.=s|GENRE=m
Jacque	Jacques	NOMpro	NOMB.=s|GENRE=m
en	en	PRE	MORPH=empty
galice	Galice	NOMpro	NOMB.=s|GENRE=f
Appetoit	appéter	VERcjg	MODE=ind|TEMPS=ipf|PERS.=3|NOMB.=s
fort	fort	ADVgen	MORPH=empty
luy	il	PROper	PERS.=3|NOMB.=s|GENRE=m|CAS=i
faire	faire	VERinf	MORPH=empty
preiudice	préjudice	NOMcom	NOMB.=s|GENRE=m
De	de	PRE	MORPH=empty
ſon	son	DETpos	PERS.=3|NOMB.=s|GENRE=m
bourdon	bourdon	NOMcom	NOMB.=s|GENRE=m
dont	dont	PROrel	NOMB.=s|GENRE=m
il	il	PROper	PERS.=3|NOMB.=s|GENRE=m|CAS=n
fiſt	faire	VERcjg	MODE=ind|TEMPS=psp|PERS.=3|NOMB.=s
ung	un	ADJqua	NOMB.=s|GENRE=m
flaiol	flageol	NOMcom	NOMB.=s|GENRE=m
.	.	PONfrt	MORPH=empty
Sainct	saint	ADJqua	NOMB.=s|GENRE=m
Marc	Marc	NOMpro	NOMB.=s|GENRE=m
le	il	PROper	PERS.=3|NOMB.=s|GENRE=n|CAS=r
ſceut	savoir	VERcjg	MODE=ind|TEMPS=psp|PERS.=3|NOMB.=s
il	il	PROper	PERS.=3|NOMB.=s|GENRE=m|CAS=n
luy	il	PROper	PERS.=3|NOMB.=s|GENRE=m|CAS=i
deſpleut	déplaire	VERcjg	MODE=ind|TEMPS=psp|PERS.=3|NOMB.=s
du	de_le	PRE.DETdef	NOMB.=s|GENRE=m
dol	dol	NOMcom	NOMB.=s|GENRE=m
Et	et	CONcoo	MORPH=empty
de	de	PRE	MORPH=empty
la	le	DETdef	NOMB.=s|GENRE=f
fraulde	fraude	NOMcom	NOMB.=s|GENRE=f
alors	alors	ADVgen	MORPH=empty
d	de	PRE	MORPH=empty
ung	un	DETndf	NOMB.=s|GENRE=m
gros	gros	ADJqua	NOMB.=s|GENRE=m
licol	licol	NOMcom	NOMB.=s|GENRE=m
Lya	lier	VERcjg	MODE=ind|TEMPS=psp|PERS.=3|NOMB.=s
Rommains	Romain	NOMpro	NOMB.=p|GENRE=m
,	,	PONfbl	MORPH=empty
congnoiſſant	connaître	VERppa	NOMB.=s|GENRE=m
le	le	DETdef	NOMB.=s|GENRE=m
malice	malice	NOMcom	NOMB.=s|GENRE=m
fainct	feindre	VERppe	NOMB.=s|GENRE=m
.	.	PONfrt	MORPH=empty
Sainct	saint	ADJqua	NOMB.=s|GENRE=m
Andre	André	NOMpro	NOMB.=s|GENRE=m
uint	venir	VERppe	MODE=ind|TEMPS=psp|PERS.=3|NOMB.=s
en	en	PRE	MORPH=empty
ſecret	secret	NOMcom	NOMB.=s|GENRE=m
de	de	PRE	MORPH=empty
plain	plein	ADJqua	NOMB.=s|GENRE=m
uol	vol	NOMcom	NOMB.=s|GENRE=m
Cuydant	cuider	VERppa	NOMB.=s|GENRE=m
trouuer	trouver	VERinf	MORPH=empty
ſainct	saint	ADJqua	NOMB.=s|GENRE=m
Frãcois	François	NOMpro	NOMB.=s|GENRE=m
laſche	lâche	ADJqua	NOMB.=s|GENRE=m
et	et	CONcoo	MORPH=empty
mol	mou	ADJqua	NOMB.=s|GENRE=m
Qui	qui	PROrel	NOMB.=s|GENRE=m
deſira	désirer	VERcjg	MODE=ind|TEMPS=psp|PERS.=3|NOMB.=s
ſoy	il	PROper	PERS.=3|NOMB.=s|GENRE=m|CAS=r
uenger	venger	VERinf	MORPH=empty
d	de	PRE	MORPH=empty
ung	un	DETndf	NOMB.=s|GENRE=m
tel	tel	DETind	NOMB.=s|GENRE=m
uice	vice	NOMcom	NOMB.=s|GENRE=m
Sainct	saint	ADJqua	NOMB.=s|GENRE=m
George	George	NOMpro	NOMB.=s|GENRE=m
y	y	PROadv	MORPH=empty
fut	être	VERcjg	MODE=ind|TEMPS=psp|PERS.=3|NOMB.=s
comme	comme	CONsub	MORPH=empty
chef	chef	NOMcom	NOMB.=s|GENRE=m
de	de	PRE	MORPH=empty
iuſtice	justice	NOMcom	NOMB.=s|GENRE=f
Apperceut	apercevoir	VERcjg	MODE=ind|TEMPS=psp|PERS.=3|NOMB.=s
bien	bien	ADVgen	MORPH=empty
que	que	CONsub	MORPH=empty
l	le	DETdef	NOMB.=s|GENRE=m
ung	un	PROind	NOMB.=s|GENRE=m
de	de	PRE	MORPH=empty
eulx	il	PROper	PERS.=3|NOMB.=p|GENRE=m|CAS=i
eſtoit	être	VERcjg	MODE=ind|TEMPS=ipf|PERS.=3|NOMB.=s
fol	fou	ADJqua	NOMB.=s|GENRE=m
fainct	feindre	VERppe	NOMB.=s|GENRE=m
Raiſon	raison	NOMcom	NOMB.=s|GENRE=f
par	par	PRE	MORPH=empty
tout	tout	PROind	NOMB.=s|GENRE=n
.	.	PONfrt	MORPH=empty
Menus	menu	ADJqua	NOMB.=p|GENRE=m
propos	propos	NOMcom	NOMB.=p|GENRE=m
de	de	PRE	MORPH=empty
la	le	DETdef	NOMB.=s|GENRE=f
maniere	manière	NOMcom	NOMB.=s|GENRE=f
de	de	PRE	MORPH=empty
ſoy	il	PROper	PERS.=3|NOMB.=s|GENRE=x|CAS=r
gouuerner	gouverner	VERinf	MORPH=empty
es	en_le	PRE.DETdef	NOMB.=p|GENRE=f
cours	cours	NOMcom	NOMB.=p|GENRE=f
des	de_le	PRE.DETdef	NOMB.=p|GENRE=m
princes	prince	NOMcom	NOMB.=p|GENRE=m
Le	le	DETdef	NOMB.=s|GENRE=m
curial	curial	NOMcom	NOMB.=s|GENRE=m
.	.	PONfrt	MORPH=empty
HOmme	homme	NOMcom	NOMB.=s|GENRE=m
qui	qui	PROrel	NOMB.=s|GENRE=m
ueult	vouloir	VERcjg	MODE=ind|TEMPS=pst|PERS.=3|NOMB.=s
ſoy	il	PROper	PERS.=3|NOMB.=s|GENRE=m|CAS=r
mettre	mettre	VERinf	MORPH=empty
en	en	PRE	MORPH=empty
ſeruitude	servitude	NOMcom	NOMB.=s|GENRE=f
Cuydant	cuider	VERppa	NOMB.=s|GENRE=m
auoir	avoir	VERinf	MORPH=empty
aux	à_le	PRE.DETdef	NOMB.=p|GENRE=m
princes	prince	NOMcom	NOMB.=p|GENRE=m
habitude	habitude	NOMcom	NOMB.=s|GENRE=f
Suyuant	suivre	VERppa	NOMB.=s|GENRE=m
la	le	DETdef	NOMB.=s|GENRE=f
court	cour	NOMcom	NOMB.=s|GENRE=f
doit	devoir	VERcjg	MODE=ind|TEMPS=pst|PERS.=3|NOMB.=s
regarder	regarder	VERinf	MORPH=empty
comment	comment	ADVgen	MORPH=empty
Pourra	pouvoir	VERcjg	MODE=ind|TEMPS=fut|PERS.=3|NOMB.=s
complaire	complaire	VERinf	MORPH=empty
a	à	PRE	MORPH=empty
une	un	DETndf	NOMB.=s|GENRE=f
multitude	multitude	NOMcom	NOMB.=s|GENRE=f
De	de	PRE	MORPH=empty
gens	gens	NOMcom	NOMB.=p|GENRE=m
qui	qui	PROrel	NOMB.=p|GENRE=m
ſont	être	VERcjg	MODE=ind|TEMPS=pst|PERS.=3|NOMB.=p
differendz	différent	ADJqua	NOMB.=p|GENRE=m
en	en	PRE	MORPH=empty
eſtude	étude	NOMcom	NOMB.=s|GENRE=f
Par	par	PRE	MORPH=empty
diuers	divers	ADJqua	NOMB.=p|GENRE=m
ſens	sens	NOMcom	NOMB.=p|GENRE=m
et	et	CONcoo	MORPH=empty
prompt	prompt	ADJqua	NOMB.=s|GENRE=m
entendement	entendement	NOMcom	NOMB.=s|GENRE=m
Sa	son	DETpos	PERS.=3|NOMB.=s|GENRE=f
liberte	liberté	NOMcom	NOMB.=s|GENRE=f
laiſſe	laisser	VERcjg	MODE=ind|TEMPS=pst|PERS.=3|NOMB.=s
totallement	totalement	ADVgen	MORPH=empty
Tes	ton	DETpos	PERS.=2|NOMB.=p|GENRE=m
eſcoliers	écolier	NOMcom	NOMB.=p|GENRE=m
te	tu	PROper	PERS.=2|NOMB.=s|GENRE=x|CAS=i
feront	faire	VERcjg	MODE=ind|TEMPS=fut|PERS.=3|NOMB.=p
maintz	maint	DETind	NOMB.=p|GENRE=m
oultraiges	outrage	NOMcom	NOMB.=p|GENRE=m
Car	car	CONcoo	MORPH=empty
ilz	il	PROper	PERS.=3|NOMB.=p|GENRE=m|CAS=n
prendront	prendre	VERcjg	MODE=ind|TEMPS=fut|PERS.=3|NOMB.=p
a	à	PRE	MORPH=empty
te	tu	PROper	PERS.=2|NOMB.=s|GENRE=x|CAS=r
greuer	grever	VERinf	MORPH=empty
deduitz	déduit	NOMcom	NOMB.=s|GENRE=m
Te	tu	PROper	PERS.=2|NOMB.=s|GENRE=x|CAS=i
faire	faire	VERinf	MORPH=empty
mal	mal	ADJqua	NOMB.=p|GENRE=m
deplaiſirs	déplaisir	NOMcom	NOMB.=p|GENRE=m
et	et	CONcoo	MORPH=empty
ennuitz	ennui	NOMcom	NOMB.=p|GENRE=m
Tenant	tenir	VERppa	NOMB.=p|GENRE=m
ſuſpectz	suspect	ADVgen	MORPH=empty
tes	ton	DETpos	PERS.=2|NOMB.=p|GENRE=m
enſeignemẽs	enseignement	NOMcom	NOMB.=p|GENRE=m
ſaiges	sage	ADJqua	NOMB.=p|GENRE=m
Ainſi	ainsi	ADVgen	MORPH=empty
ta	ton	DETpos	PERS.=2|NOMB.=s|GENRE=f
uie	vie	NOMcom	NOMB.=s|GENRE=f
uſeras	user	VERcjg	MODE=ind|TEMPS=fut|PERS.=2^|NOMB.=s
en	en	PRE	MORPH=empty
langaiges	langage	NOMcom	NOMB.=p|GENRE=m
Et	et	PRE	MORPH=empty
en	en	PRE	MORPH=empty
danger	danger	NOMcom	NOMB.=s|GENRE=m
auec	avec	PRE	MORPH=empty
gens	gens	NOMcom	NOMB.=p|GENRE=m
enuieulx	envieux	ADJqua	NOMB.=p|GENRE=m
L	le	DETdef	NOMB.=s|GENRE=m
eſtat	état	NOMcom	NOMB.=s|GENRE=m
de	de	PRE	MORPH=empty
court	cour	NOMcom	NOMB.=s|GENRE=f
plꝰ	plus	ADVgen	MORPH=empty
que	que	CONsub	MORPH=empty
autre	autre	PROind	NOMB.=s|GENRE=m
eſt	être	VERcjg	MODE=ind|TEMPS=pst|PERS.=3|NOMB.=s
perilleux	périlleux	ADJqua	NOMB.=s|GENRE=m
Sil	si_il	CONsub.PROimp	PERS.=0|NOMB.=s|GENRE=n|CAS=n
te	tu	PROper	PERS.=2|NOMB.=s|GENRE=x|CAS=r
prenoit	prendre	VERcjg	MODE=con|PERS.=3|NOMB.=s
conſiderant	considérer	VERppa	NOMB.=s|GENRE=x
ta	ton	DETpos	PERS.=2|NOMB.=s|GENRE=f
uie	vie	NOMcom	NOMB.=s|GENRE=f
De	de	PRE	MORPH=empty
te	tu	PROper	PERS.=2|NOMB.=s|GENRE=x|CAS=r
uenger	venger	VERinf	MORPH=empty
de	de	PRE	MORPH=empty
leur	leur	DETpos	PERS.=3|NOMB.=s|GENRE=f
cruelle	cruel	ADJqua	NOMB.=s|GENRE=f
enuie	envie	NOMcom	NOMB.=s|GENRE=f
Tant	tant	ADVgen	MORPH=empty
pis	pis	ADVgen	MORPH=empty
uauldroit	valoir	VERcjg	MODE=con|PERS.=3|NOMB.=s
que	que	CONsub	MORPH=empty
ſans	sans	PRE	MORPH=empty
difficulte	difficulté	NOMcom	NOMB.=s|GENRE=f
Ton	ton	DETpos	PERS.=2|NOMB.=s|GENRE=m
uengement	vengement	NOMcom	NOMB.=s|GENRE=m
ne	ne	ADVneg	MORPH=empty
ſeroit	être	VERcjg	MODE=con|PERS.=3|NOMB.=s
que	que	CONsub	MORPH=empty
follie	folie	NOMcom	NOMB.=s|GENRE=f
Qui	qui	PROrel	NOMB.=s|GENRE=f
cauſeroit	causer	VERcjg	MODE=con|PERS.=3|NOMB.=s
en	en	PRE	MORPH=empty
toy	tu	PROper	PERS.=2|NOMB.=s|GENRE=x|CAS=i
contumelie	contumélie	NOMcom	NOMB.=s|GENRE=f
Debatz	débat	NOMcom	NOMB.=p|GENRE=m
:	:	PONfbl	MORPH=empty
tenſons	tançon	NOMcom	NOMB.=p|GENRE=f
et	et	CONcoo	MORPH=empty
plus	plus	ADVgen	MORPH=empty
d	de	PRE	MORPH=empty
auerſitez	adversité	NOMcom	NOMB.=p|GENRE=f
Que	que	CONsub	MORPH=empty
par	par	PRE	MORPH=empty
autant	autant	ADVgen	MORPH=empty
uaines	vain	ADJqua	NOMB.=p|GENRE=f
auctoritez	autorité	NOMcom	NOMB.=p|GENRE=f
Folz	fou	ADJqua	NOMB.=p|GENRE=m
curiaulx	curial	NOMcom	NOMB.=p|GENRE=m
les	il	PROper	PERS.=3|NOMB.=p|GENRE=x|CAS=r
deſirent	désirer	VERcjg	MODE=ind|TEMPS=pst|PERS.=3|NOMB.=p
et	et	CONcoo	MORPH=empty
priſent	priser	VERcjg	MODE=ind|TEMPS=pst|PERS.=3|NOMB.=p
Ceulx	celui	PROdem	NOMB.=p|GENRE=m
ont	avoir	VERcjg	MODE=ind|TEMPS=pst|PERS.=3|NOMB.=p
le	le	DETdef	NOMB.=s|GENRE=m
bruit	bruit	NOMcom	NOMB.=s|GENRE=m
qͥ	qui	PROrel	NOMB.=s|GENRE=m
en	en	PRE	MORPH=empty
court	cour	NOMcom	NOMB.=s|GENRE=f
temporiſent	temporiser	VERcjg	MODE=ind|TEMPS=pst|PERS.=3|NOMB.=p
Les	le	DETdef	NOMB.=p|GENRE=m
grans	grand	ADJqua	NOMB.=p|GENRE=m
abus	abus	NOMcom	NOMB.=p|GENRE=m
des	de_le	PRE.DETdef	NOMB.=p|GENRE=f
cours	cour	NOMcom	NOMB.=p|GENRE=f
et	et	CONcoo	MORPH=empty
la	le	DETdef	NOMB.=s|GENRE=f
maniere	manière	NOMcom	NOMB.=s|GENRE=f
Des	de_le	PRE.DETdef	NOMB.=p|GENRE=m
curiaulx	curial	NOMcom	NOMB.=p|GENRE=m
ſont	être	VERcjg	MODE=ind|TEMPS=pst|PERS.=3|NOMB.=p
telz	tel	DETind	NOMB.=p|GENRE=m
quil	que_il	CONsub.PROper	PERS.=3|NOMB.=s|GENRE=m|CAS=n
n	ne	ADVneg	MORPH=empty
y	y	PROadv	MORPH=empty
a	avoir	VERcjg	MODE=ind|TEMPS=pst|PERS.=3|NOMB.=s
guiere	guère	ADVgen	MORPH=empty
Homme	homme	NOMcom	NOMB.=s|GENRE=m
qui	qui	PROrel	NOMB.=s|GENRE=m
ſoit	être	VERcjg	MODE=sub|TEMPS=pst|PERS.=3|NOMB.=s
ſouffert	souffrir	VERppe	NOMB.=s|GENRE=m
ſoy	il	PROper	PERS.=3|NOMB.=s|GENRE=m|CAS=r
eſleuer	élever	VERinf	MORPH=empty
Se	si	CONsub	MORPH=empty
corrompable	corrompable	ADJqua	NOMB.=s|GENRE=m
il	il	PROper	PERS.=3|NOMB.=s|GENRE=m|CAS=n
n	ne	ADVneg	MORPH=empty
eſt	être	VERcjg	MODE=ind|TEMPS=pst|PERS.=3|NOMB.=s
par	par	PRE	MORPH=empty
belle	beau	ADJqua	NOMB.=s|GENRE=f
chere	chère	NOMcom	NOMB.=s|GENRE=f
Ou	ou	CONcoo	MORPH=empty
par	par	PRE	MORPH=empty
flater	flatter	VERinf	MORPH=empty
ou	ou	CONcoo	MORPH=empty
railler	railler	VERinf	MORPH=empty
en	en	PRE	MORPH=empty
derriere	derrière	NOMcom	NOMB.=s|GENRE=m
Ou	ou	CONcoo	MORPH=empty
en	en	PRE	MORPH=empty
ſecret	secret	NOMcom	NOMB.=s|GENRE=m
ung	un	DETndf	NOMB.=s|GENRE=m
menſonge	mensonge	NOMcom	NOMB.=s|GENRE=m
trouuer	trouver	VERinf	MORPH=empty
Les	le	DETdef	NOMB.=p|GENRE=m
uertueulx	vertueux	NOMcom	NOMB.=p|GENRE=m
on	on	PROper	PERS.=3|NOMB.=s|GENRE=x|CAS=n
taſche	tâcher	VERcjg	MODE=ind|TEMPS=pst|PERS.=3|NOMB.=s
de	de	PRE	MORPH=empty
greuer	grever	VERinf	MORPH=empty
Aux	à_le	PRE.DETdef	NOMB.=p|GENRE=m
folz	fou	NOMcom	NOMB.=p|GENRE=m
deſplaiſt	déplaire	VERcjg	MODE=ind|TEMPS=pst|PERS.=3|NOMB.=s
ouyr	ouïr	VERinf	MORPH=empty
ung	un	DETndf	NOMB.=s|GENRE=m
bon	bon	ADJqua	NOMB.=s|GENRE=m
notable	notable	NOMcom	NOMB.=s|GENRE=m
Car	car	CONcoo	MORPH=empty
les	le	DETdef	NOMB.=p|GENRE=m
grans	grand	ADJqua	NOMB.=p|GENRE=m
uentz	vent	NOMcom	NOMB.=p|GENRE=m
qui	qui	PROrel	NOMB.=p|GENRE=m
ſont	être	VERcjg	MODE=ind|TEMPS=pst|PERS.=3|NOMB.=p
es	en_le	DETndf	NOMB.=p|GENRE=f
haultes	haut	ADJqua	NOMB.=p|GENRE=f
cours	cours	NOMcom	NOMB.=p|GENRE=f
Ont	avoir	VERcjg	MODE=ind|TEMPS=pst|PERS.=3|NOMB.=p
tel	tel	DETind	NOMB.=s|GENRE=f
facon	façon	NOMcom	NOMB.=s|GENRE=f
que	que	CONsub	MORPH=empty
ceulx	celui	PROdem	NOMB.=p|GENRE=m
qui	qui	PROrel	NOMB.=p|GENRE=m
ont	avoir	VERcjg	MODE=ind|TEMPS=pst|PERS.=3|NOMB.=p
le	le	DETdef	NOMB.=s|GENRE=m
cours	cours	NOMcom	NOMB.=s|GENRE=m
Et	et	CONcoo	MORPH=empty
laudiui	laudiui	VERppe	NOMB.=s|GENRE=m
en	en	PRE	MORPH=empty
mondain	mondain	ADJqua	NOMB.=s|GENRE=m
habitacle	habitacle	NOMcom	NOMB.=s|GENRE=m
Ne	ne	ADVneg	MORPH=empty
ſouffriront	souffrir	VERcjg	MODE=ind|TEMPS=fut|PERS.=3|NOMB.=p
touſiours	toujours	ADVgen	MORPH=empty
auoir	avoir	VERinf	MORPH=empty
ſecours	secours	NOMcom	NOMB.=s|GENRE=m
Mais	mais	CONcoo	MORPH=empty
ſouffleront	souffler	VERcjg	MODE=ind|TEMPS=fut|PERS.=3|NOMB.=p
pour	pour	PRE	MORPH=empty
les	il	PROper	PERS.=3|NOMB.=p|GENRE=m|CAS=r
mettre	mettre	VERinf	MORPH=empty
a	à	PRE	MORPH=empty
decours	décours	NOMcom	NOMB.=p|GENRE=m
Tombant	tomber	VERppa	NOMB.=p|GENRE=m
en	en	PRE	MORPH=empty
bas	bas	NOMcom	NOMB.=s|GENRE=m
eulx	il	PROper	PERS.=3|NOMB.=p|GENRE=m|CAS=n
et	et	CONcoo	MORPH=empty
leur	leur	DETpos	PERS.=3|NOMB.=s|GENRE=m
habitacle	habitacle	NOMcom	NOMB.=s|GENRE=m
Eulx	il	PROper	PERS.=3|NOMB.=p|GENRE=m|CAS=n
hors	hors	PRE	MORPH=empty
de	de	PRE	MORPH=empty
bruit	bruit	NOMcom	NOMB.=s|GENRE=m
ſeront	être	VERcjg	MODE=ind|TEMPS=fut|PERS.=3|NOMB.=p
comme	comme	CONsub	MORPH=empty
ung	un	DETndf	NOMB.=s|GENRE=m
ſpectacle	spectacle	NOMcom	NOMB.=s|GENRE=m
Faict	faire	VERppe	NOMB.=s|GENRE=m
par	par	PRE	MORPH=empty
enuie	envie	NOMcom	NOMB.=s|GENRE=f
et	et	CONcoo	MORPH=empty
par	par	PRE	MORPH=empty
detraction	détraction	NOMcom	NOMB.=s|GENRE=f
A	à	PRE	MORPH=empty
hault	haut	ADVgen	MORPH=empty
monter	monter	VERinf	MORPH=empty
ne	ne	ADVneg	MORPH=empty
giſt	gésir	VERcjg	MODE=ind|TEMPS=pst|PERS.=3|NOMB.=s
perfection	perfection	NOMcom	NOMB.=s|GENRE=f
Et	et	CONcoo	MORPH=empty
ſil	si_il	CONsub.PROimp	PERS.=0|NOMB.=s|GENRE=n|CAS=n
aduient	advenir	VERcjg	MODE=ind|TEMPS=pst|PERS.=3|NOMB.=s
que	que	CONsub	MORPH=empty
ceulx	celui	PROdem	NOMB.=p|GENRE=m
qui	qui	PROrel	NOMB.=p|GENRE=m
ont	avoir	VERcjg	MODE=ind|TEMPS=pst|PERS.=3|NOMB.=p
eu	avoir	VERppe	NOMB.=p|GENRE=m
nom	nom	NOMcom	NOMB.=s|GENRE=m
De	de	PRE	MORPH=empty
dominer	dominer	VERinf	MORPH=empty
perdent	perdre	VERcjg	MODE=ind|TEMPS=pst|PERS.=3|NOMB.=p
bruit	bruit	NOMcom	NOMB.=s|GENRE=m
et	et	CONcoo	MORPH=empty
renom	renom	NOMcom	NOMB.=s|GENRE=m
Et	et	CONcoo	MORPH=empty
rauallez	ravaler	VERppe	NOMB.=p|GENRE=m
hors	hors	PRE	MORPH=empty
de	de	PRE	MORPH=empty
court	cour	NOMcom	NOMB.=s|GENRE=f
on	on	PROper	PERS.=3|NOMB.=s|GENRE=x|CAS=n
les	il	PROper	PERS.=3|NOMB.=p|GENRE=m|CAS=r
uoye	voir	VERcjg	MODE=ind|TEMPS=pst|PERS.=3|NOMB.=s
Du	de_le	PRE.DETdef	NOMB.=s|GENRE=m
peuple	peuple	NOMcom	NOMB.=s|GENRE=m
auront	avoir	VERcjg	MODE=ind|TEMPS=fut|PERS.=3|NOMB.=p
bientoſt	bientôt	ADVgen	MORPH=empty
quelque	quelque	DETind	NOMB.=s|GENRE=m
lardon	lardon	NOMcom	NOMB.=s|GENRE=m
Voila	voilà	VERcjg	MODE=imp|NOMB.=s|PERS.=3
leur	leur	DETpos	PERS.=3|NOMB.=s|GENRE=f
fin	fin	NOMcom	NOMB.=s|GENRE=f
et	et	CONcoo	MORPH=empty
leur	leur	DETpos	PERS.=3|NOMB.=s|GENRE=m
dernier	dernier	ADJqua	NOMB.=s|GENRE=m
guerdon	guerdon	NOMcom	NOMB.=s|GENRE=m
Fortune	fortune	NOMcom	NOMB.=s|GENRE=f
ainſi	ainsi	ADVgen	MORPH=empty
ceulx	celui	PROdem	NOMB.=p|GENRE=m
que	que	PROrel	NOMB.=p|GENRE=m
a	avoir	VERcjg	MODE=ind|TEMPS=pst|PERS.=3|NOMB.=s
mis	mettre	VERppe	NOMB.=s|GENRE=f
hault	haut	ADVgen	MORPH=empty
deſuoye	dévoyer	VERcjg	MODE=ind|TEMPS=pst|PERS.=3|NOMB.=s
.	.	PONfrt	MORPH=empty
Chaſcun	chacun	PROind	NOMB.=s|GENRE=x
ſ	il	PROper	PERS.=3|NOMB.=p|GENRE=x|CAS=r
en	en	PROadv	MORPH=empty
rit	rire	VERcjg	MODE=ind|TEMPS=pst|PERS.=3|NOMB.=s
et	et	CONcoo	MORPH=empty
mocque	moquer	VERcjg	MODE=ind|TEMPS=pst|PERS.=3|NOMB.=s
par	par	PRE	MORPH=empty
la	le	DETdef	NOMB.=s|GENRE=f
uoye	voir	NOMcom	NOMB.=s|GENRE=f
Ses	son	DETpos	PERS.=3|NOMB.=p|GENRE=m
faicts	fait	NOMcom	NOMB.=p|GENRE=m
paſſez	passer	VERppe	NOMB.=p|GENRE=m
on	on	PROper	PERS.=3|NOMB.=s|GENRE=x|CAS=n
taſche	tâcher	VERcjg	MODE=ind|TEMPS=pst|PERS.=3|NOMB.=s
a	à	PRE	MORPH=empty
eſplucher	éplucher	VERinf	MORPH=empty
Plus	plus	ADVgen	MORPH=empty
l	le	DETdef	NOMB.=s|GENRE=m
homme	homme	NOMcom	NOMB.=s|GENRE=m
eſt	être	VERcjg	MODE=ind|TEMPS=pst|PERS.=3|NOMB.=s
hault	haut	ADJqua	NOMB.=s|GENRE=m
plus	plus	ADVgen	MORPH=empty
craint	craindre	VERcjg	MODE=ind|TEMPS=pst|PERS.=3|NOMB.=s
a	à	PRE	MORPH=empty
treſbucher	trébucher	VERinf	MORPH=empty
Aucuneffois	aucunefois	ADVgen	MORPH=empty
fortune	fortune	NOMcom	NOMB.=s|GENRE=f
ueult	vouloir	VERcjg	MODE=ind|TEMPS=pst|PERS.=3|NOMB.=s
monter	monter	VERinf	MORPH=empty
Quelque	quelque	DETind	NOMB.=s|GENRE=m
poure	pauvre	ADJqua	NOMB.=s|GENRE=m
homme	homme	NOMcom	NOMB.=s|GENRE=m
et	et	CONcoo	MORPH=empty
le	il	PROper	PERS.=3|NOMB.=s|GENRE=m|CAS=r
faict	fait	VERcjg	MODE=ind|TEMPS=pst|PERS.=3|NOMB.=s
ſurmonter	surmonter	VERinf	MORPH=empty
Ses	son	DETpos	PERS.=3|NOMB.=p|GENRE=m
compagnons	compagnon	NOMcom	NOMB.=p|GENRE=m
qui	qui	PROrel	NOMB.=s|GENRE=m
n	ne	ADVneg	MORPH=empty
eſt	être	VERcjg	MODE=ind|TEMPS=pst|PERS.=3|NOMB.=s
q	que	CONsub	MORPH=empty
un	un	DETndf	NOMB.=s|GENRE=m
ualidire	va-lui-dire	NOMcom	NOMB.=s|GENRE=m
Sil	si_il	CONsub.PROper	PERS.=3|NOMB.=s|GENRE=m|CAS=n
s	il	PROper	PERS.=3|NOMB.=s|GENRE=m|CAS=r
enrichiſt	enrichir	VERcjg	MODE=ind|TEMPS=pst|PERS.=3|NOMB.=s
par	par	PRE	MORPH=empty
prendre	prendre	VERinf	MORPH=empty
ou	ou	CONcoo	MORPH=empty
meſcompter	mécompter	VERinf	MORPH=empty
Et	et	CONcoo	MORPH=empty
puis	puis	ADVgen	MORPH=empty
deſcend	descendre	VERcjg	MODE=ind|TEMPS=pst|PERS.=3|NOMB.=s
ſans	sans	PRE	MORPH=empty
les	le	DETdef	NOMB.=p|GENRE=m
degrez	degré	NOMcom	NOMB.=p|GENRE=m
compter	compter	VERinf	MORPH=empty
Fortune	fortune	NOMcom	NOMB.=s|GENRE=f
alors	alors	ADVgen	MORPH=empty
ne	ne	ADVneg	MORPH=empty
ſ	il	PROper	PERS.=3|NOMB.=s|GENRE=f|CAS=i
en	en	PROadv	MORPH=empty
faict	faire	VERcjg	MODE=ind|TEMPS=pst|PERS.=3|NOMB.=s
que	que	CONsub	MORPH=empty
ſoubzrire	sourire	VERinf	MORPH=empty
Mais	mais	CONcoo	MORPH=empty
des	de_le	PRE.DETdef	NOMB.=p|GENRE=m
plus	plus	ADVgen	MORPH=empty
grans	grand	NOMcom	NOMB.=p|GENRE=m
que	que	CONsub	MORPH=empty
eſleue	élève	NOMcom	NOMB.=s|GENRE=m
ie	je	PROper	PERS.=1|NOMB.=s|GENRE=x|CAS=n
puis	pouvoir	VERcjg	MODE=ind|TEMPS=pst|PERS.=1|NOMB.=s
dire	dire	VERinf	MORPH=empty
Que	que	CONsub	MORPH=empty
a	à	PRE	MORPH=empty
gueulle	gueule	NOMcom	NOMB.=s|GENRE=f
bee	béer	VERppe	NOMB.=s|GENRE=f
en	en	PROadv	MORPH=empty
rit	rire	VERcjg	MODE=ind|TEMPS=pst|PERS.=3|NOMB.=s
ſes	son	DETdem	PERS.=3|NOMB.=p|GENRE=f
paulmes	paume	NOMcom	NOMB.=p|GENRE=f
bat	battre	VERcjg	MODE=ind|TEMPS=pst|PERS.=3|NOMB.=s
L	le	DETdef	NOMB.=s|GENRE=m
orgueil	orgueil	NOMcom	NOMB.=s|GENRE=m
mondain	mondain	ADJqua	NOMB.=s|GENRE=m
dieu	dieu	NOMcom	NOMB.=s|GENRE=m
le	il	PROper	PERS.=3|NOMB.=s|GENRE=m|CAS=r
hait	haïr	VERcjg	MODE=ind|TEMPS=pst|PERS.=3|NOMB.=s
et	et	CONcoo	MORPH=empty
rabat	rabattre	VERcjg	MODE=ind|TEMPS=pst|PERS.=3|NOMB.=s
Qui	qui	PROrel	NOMB.=s|GENRE=x
ſert	servir	VERcjg	MODE=ind|TEMPS=pst|PERS.=3|NOMB.=s
en	en	PRE	MORPH=empty
court	cour	NOMcom	NOMB.=s|GENRE=f
laiſſe	laisser	VERcjg	MODE=ind|TEMPS=pst|PERS.=3|NOMB.=s
pour	pour	PRE	MORPH=empty
le	le	DETdef	NOMB.=s|GENRE=m
iourdhuy	jourd'hui	NOMcom	NOMB.=s|GENRE=m
Ses	son	DETpos	PERS.=3|NOMB.=p|GENRE=f
propres	propre	ADJqua	NOMB.=p|GENRE=f
meurs	mœurs	NOMcom	NOMB.=p|GENRE=f
pour	pour	PRE	MORPH=empty
complaire	complaire	VERinf	MORPH=empty
a	à	PRE	MORPH=empty
aultruy	autrui	PROind	NOMB.=s|GENRE=n
Ce	ce	PROdem	NOMB.=s|GENRE=n
qui	qui	PROrel	NOMB.=s|GENRE=n
peu	peu	ADVgen	MORPH=empty
uault	valoir	VERcjg	MODE=ind|TEMPS=pst|PERS.=3|NOMB.=s
il	il	PROper	PERS.=3|NOMB.=s|GENRE=m|CAS=n
l	il	PROper	PERS.=3|NOMB.=s|GENRE=n|CAS=r
honore	honorer	VERcjg	MODE=ind|TEMPS=pst|PERS.=3|NOMB.=s
et	et	CONcoo	MORPH=empty
le	le	PROper	PERS.=3|NOMB.=s|GENRE=n|CAS=r
priſe	priser	VERcjg	MODE=ind|TEMPS=pst|PERS.=3|NOMB.=s
Sil	si_il	CONsub.PROper	PERS.=3|NOMB.=s|GENRE=m|CAS=n
ayme	aimer	VERcjg	MODE=ind|TEMPS=pst|PERS.=3|NOMB.=s
honneur	honneur	NOMcom	NOMB.=s|GENRE=m
deſhonneur	déshonneur	NOMcom	NOMB.=s|GENRE=m
uient	venir	VERcjg	MODE=ind|TEMPS=pst|PERS.=3|NOMB.=s
uers	vers	PRE	MORPH=empty
luy	il	PROper	PERS.=3|NOMB.=s|GENRE=m|CAS=i
Se	si	CONsub	MORPH=empty
eſt	être	VERcjg	MODE=ind|TEMPS=pst|PERS.=3|NOMB.=s
patient	patient	ADJqua	NOMB.=s|GENRE=m
ſouffrette	souffrète	NOMcom	NOMB.=s|GENRE=f
a	avoir	VERcjg	MODE=ind|TEMPS=pst|PERS.=3|NOMB.=s
pour	pour	PRE	MORPH=empty
appuy	appui	NOMcom	NOMB.=s|GENRE=m
Le	le	DETdef	NOMB.=s|GENRE=m
ueritable	véritable	NOMcom	NOMB.=s|GENRE=m
on	on	PROper	PERS.=3|NOMB.=s|GENRE=x|CAS=n
tempte	tenter	VERcjg	MODE=ind|TEMPS=pst|PERS.=3|NOMB.=s
de	de	PRE	MORPH=empty
faintiſe	feintise	NOMcom	NOMB.=s|GENRE=f
Et	et	CONcoo	MORPH=empty
ſil	si_il	CONsub.PROper	PERS.=3|NOMB.=s|GENRE=m|CAS=n
ne	ne	ADVneg	MORPH=empty
ueult	vouloir	VERcjg	MODE=ind|TEMPS=pst|PERS.=3|NOMB.=s
faire	faire	VERinf	MORPH=empty
quelque	quelque	DETind	NOMB.=s|GENRE=f
entrepriſe	entreprise	NOMcom	NOMB.=s|GENRE=f
De	de	PRE	MORPH=empty
demander	demander	VERinf	MORPH=empty
il	il	PROper	PERS.=3|NOMB.=s|GENRE=m|CAS=n
ſera	être	VERcjg	MODE=ind|TEMPS=fut|PERS.=3|NOMB.=s
ſouffreteux	souffreteux	ADJqua	NOMB.=s|GENRE=m
Qui	qui	PROrel	NOMB.=s|GENRE=x
hante	hanter	VERcjg	MODE=sub|TEMPS=pst|PERS.=3|NOMB.=s
es	en_le	PRE.DETdef	NOMB.=p|GENRE=f
cours	cours	NOMcom	NOMB.=p|GENRE=f
ne	ne	ADVneg	MORPH=empty
doit	devoir	VERcjg	MODE=ind|TEMPS=pst|PERS.=3|NOMB.=s
eſtre	être	VERinf	MORPH=empty
honteux	honteux	ADJqua	NOMB.=s|GENRE=x
Se	si	CONsub	MORPH=empty
couſtume	coutume	NOMcom	NOMB.=s|GENRE=f
as	avoir	VERcjg	MODE=ind|TEMPS=pst|PERS.=2|NOMB.=s
,	,	PONfbl	MORPH=empty
de	de	PRE	MORPH=empty
manger	manger	VERinf	MORPH=empty
ſobrement	sobrement	ADVgen	MORPH=empty
Ton	ton	DETpos	PERS.=2|NOMB.=s|GENRE=m
train	train	NOMcom	NOMB.=s|GENRE=m
fauldra	falloir	VERcjg	MODE=ind|TEMPS=fut|PERS.=3|NOMB.=s
changer	changer	VERinf	MORPH=empty
totallement	totalement	ADVgen	MORPH=empty
Et	et	CONcoo	MORPH=empty
delaiſſer	délaisser	VERinf	MORPH=empty
ta	ton	DETpos	PERS.=2|NOMB.=s|GENRE=f
maniere	manière	NOMcom	NOMB.=s|GENRE=f
de	de	PRE	MORPH=empty
uiure	vivre	VERinf	MORPH=empty
Qui	qui	PROrel	NOMB.=s|GENRE=x
ueult	vouloir	VERcjg	MODE=ind|TEMPS=pst|PERS.=3|NOMB.=s
repos	repos	NOMcom	NOMB.=s|GENRE=m
peine	peine	NOMcom	NOMB.=s|GENRE=f
aura	avoir	VERcjg	MODE=ind|TEMPS=fut|PERS.=3|NOMB.=s
largement	largement	ADVgen	MORPH=empty
Et	et	CONcoo	MORPH=empty
qui	qui	PROrel	NOMB.=s|GENRE=x
eſt	être	VERcjg	MODE=ind|TEMPS=pst|PERS.=3|NOMB.=s
clerc	clerc	NOMcom	NOMB.=s|GENRE=m
en	en	PRE	MORPH=empty
uoulant	vouloir	VERppa	NOMB.=s|GENRE=x
prudemment	prudemment	ADVgen	MORPH=empty
Eſtudier	étudier	VERinf	MORPH=empty
ou	ou	CONcoo	MORPH=empty
lire	lire	VERinf	MORPH=empty
en	en	PRE	MORPH=empty
quelcque	quelque	DETind	NOMB.=s|GENRE=m
liure	livre	NOMcom	NOMB.=s|GENRE=m
Oiſeux	oiseux	ADJqua	NOMB.=s|GENRE=x
ſera	être	VERcjg	MODE=ind|TEMPS=fut|PERS.=3|NOMB.=s
attendant	attendre	VERppa	NOMB.=s|GENRE=x
que	que	CONsub	MORPH=empty
on	on	PROper	PERS.=3|NOMB.=s|GENRE=x|CAS=n
luy	il	PROper	PERS.=3|NOMB.=s|GENRE=x|CAS=i
liure	livrer	VERcjg	MODE=sub|TEMPS=pst|PERS.=3|NOMB.=s
Le	le	DETdef	NOMB.=s|GENRE=m
cabinet	cabinet	NOMcom	NOMB.=s|GENRE=m
du	de_le	PRE.DETdef	NOMB.=s|GENRE=m
prince	prince	NOMcom	NOMB.=s|GENRE=m
ou	ou	CONcoo	MORPH=empty
l	le	DETdef	NOMB.=s|GENRE=m
huis	huis	NOMcom	NOMB.=s|GENRE=m
ouuert	ouvrir	VERppe	NOMB.=s|GENRE=m
Le	le	DETdef	NOMB.=s|GENRE=m
temps	temps	NOMcom	NOMB.=s|GENRE=m
perdu	perdre	VERppe	NOMB.=s|GENRE=m
n	ne	ADVneg	MORPH=empty
eſt	être	VERcjg	PERS.=3|TEMPS=pst|PERS.=3|NOMB.=s
iamais	jamais	ADVgen	MORPH=empty
recouuert	recouvrir	VERppe	NOMB.=s|GENRE=m
Seruans	servant	NOMcom	NOMB.=p|GENRE=m
de	de	PRE	MORPH=empty
court	cour	NOMcom	NOMB.=s|GENRE=f
ne	ne	ADVneg	MORPH=empty
font	faire	VERcjg	MODE=ind|TEMPS=pst|PERS.=3|NOMB.=p
que	que	CONsub	MORPH=empty
uiuoter	vivoter	VERinf	MORPH=empty
Soubz	sous	PRE	MORPH=empty
le	le	DETdef	NOMB.=s|GENRE=m
uouloir	vouloir	NOMcom	NOMB.=s|GENRE=m
d	de	PRE	MORPH=empty
altruy	autrui	PROinf	NOMB.=s|GENRE=x
et	et	CONcoo	MORPH=empty
fault	falloir	VERcjg	MODE=ind|TEMPS=pst|PERS.=3|NOMB.=s
noter	noter	VERinf	MORPH=empty
L	le	DETdef	NOMB.=s|GENRE=m
acteur	acteur	NOMcom	NOMB.=s|GENRE=m
.	.	PONfrt	MORPH=empty
Bratuler	gratuler	VERinf	MORPH=empty
don	don	NOMcom	NOMB.=s|GENRE=m
de	de	PRE	MORPH=empty
tous	tout	DETind	NOMB.=p|GENRE=m
princes	prince	NOMcom	NOMB.=p|GENRE=m
la	le	DETdef	NOMB.=s|GENRE=f
grace	grâce	NOMcom	NOMB.=s|GENRE=f
Rememorant	remémorer	VERppa	NOMB.=s|GENRE=x
les	le	DETdef	NOMB.=p|GENRE=m
grans	grand	ADJqua	NOMB.=p|GENRE=m
dangiers	danger	NOMcom	NOMB.=p|GENRE=m
des	de_le	PRE.DETdef	NOMB.=p|GENRE=f
cours	cour	NOMcom	NOMB.=p|GENRE=f
Iournellement	journellement	ADVgen	MORPH=empty
chaſcun	chacun	PROind	NOMB.=s|GENRE=m
ſon	son	DETpos	PERS.=3|NOMB.=s|GENRE=m
cas	cas	NOMcom	NOMB.=s|GENRE=m
pourchaſſe	pourchasser	VERcjg	MODE=ind|TEMPS=pst|PERS.=3|NOMB.=s
Noyſes	noise	NOMcom	NOMB.=p|GENRE=f
y	y	PROadv	MORPH=empty
ſont	être	VERcjg	MODE=ind|TEMPS=pst|PERS.=3|NOMB.=p
on	on	PROper	PERS.=3|NOMB.=s|GENRE=x|CAS=n
y	y	PROadv	MORPH=empty
trompe	tromper	VERcjg	MODE=ind|TEMPS=pst|PERS.=3|NOMB.=s
et	et	CONcoo	MORPH=empty
cabaſſe	cabasser	VERcjg	MODE=ind|TEMPS=pst|PERS.=3|NOMB.=s
Gloire	gloire	NOMcom	NOMB.=s|GENRE=f
y	y	PROadv	MORPH=empty
a	avoir	VERcjg	MODE=ind|TEMPS=pst|PERS.=3|NOMB.=s
bruyt	bruit	NOMcom	NOMB.=p|GENRE=m
audace	audace	NOMcom	NOMB.=s|GENRE=f
y	y	PROadv	MORPH=empty
eſt	être	VERcjg	MODE=ind|TEMPS=pst|PERS.=3|NOMB.=s
en	en	PRE	MORPH=empty
cours	cours	NOMcom	NOMB.=p|GENRE=f
Oultraige	outrage	NOMcom	NOMB.=s|GENRE=m
nuyt	nuire	VERcjg	MODE=ind|TEMPS=pst|PERS.=3|NOMB.=s
,	,	PONfbl	MORPH=empty
ſimple	simple	ADJqua	NOMB.=s|GENRE=x
a	à	PRE	MORPH=empty
repas	repas	NOMcom	NOMB.=x|GENRE=m
a	à	PRE	MORPH=empty
cours	cour	NOMcom	NOMB.=s|GENRE=f
Raiſon	raison	NOMcom	NOMB.=s|GENRE=f
par	par	PRE	MORPH=empty
tout	tout	PROind	NOMB.=s|GENRE=n
faict	fait	VERinf	MODE=ind|TEMPS=pst|PERS.=3|NOMB.=s
ſur	sur	PRE	MORPH=empty
le	le	DETdef	NOMB.=s|GENRE=m
texte	texte	NOMcom	NOMB.=s|GENRE=m
et	et	CONcoo	MORPH=empty
gloſe	glose	NOMcom	NOMB.=s|GENRE=f
En	en	PRE	MORPH=empty
court	cour	NOMcom	NOMB.=s|GENRE=f
ne	ne	ADVneg	MORPH=empty
aduient	advenir	VERcjg	MODE=ind|TEMPS=pst|PERS.=3|NOMB.=s
tout	tout	DETind	NOMB.=s|GENRE=n
ce	ce	PROdem	NOMB.=s|GENRE=n
que	que	PROrel	NOMB.=s|GENRE=n
lon	le_on	PROind	PERS.=3|NOMB.=s|GENRE=x|CAS=n
propoſe	proposer	VERcjg	MODE=ind|TEMPS=pst|PERS.=3|NOMB.=s
Raiſon	raison	NOMcom	NOMB.=s|GENRE=f
par	par	PRE	MORPH=empty
tout	tout	PROind	NOMB.=s|GENRE=n
.	.	PONfrt	MORPH=empty
Menus	menu	ADJqua	NOMB.=p|GENRE=m
propos	propos	NOMcom	NOMB.=p|GENRE=m
ſur	sur	PRE	MORPH=empty
la	le	DETdef	NOMB.=s|GENRE=f
chaſſe	chasse	NOMcom	NOMB.=s|GENRE=f
du	de_le	PRE.DETdef	NOMB.=s|GENRE=m
cerf	cerf	NOMcom	NOMB.=s|GENRE=m
morallement	moralement	ADVgen	MORPH=empty
et	et	CONcoo	MORPH=empty
ſelon	selon	PRE	MORPH=empty
l	le	DETdef	NOMB.=s|GENRE=m
art	art	NOMcom	NOMB.=s|GENRE=m
de	de	PRE	MORPH=empty
uenerie	vénerie	NOMcom	NOMB.=s|GENRE=f
LE	le	DETdef	NOMB.=s|GENRE=m
temps	temps	NOMcom	NOMB.=s|GENRE=m
treuue	trouver	VERppe	NOMB.=s|GENRE=m
fauoriſe	favoriser	VERcjg	MODE=ind|TEMPS=pst|PERS.=3|NOMB.=s
Entretenir	entretenir	VERinf	MORPH=empty
guerre	guerre	NOMcom	NOMB.=s|GENRE=f
ſur	sur	PRE	MORPH=empty
terre	terre	NOMcom	NOMB.=s|GENRE=f
Mais	mais	CONcoo	MORPH=empty
ce	ce	PROdem	NOMB.=s|GENRE=n
que	que	PROrel	NOMB.=s|GENRE=n
l	le	DETdef	NOMB.=s|GENRE=m
homme	homme	NOMcom	NOMB.=s|GENRE=m
a	avoir	VERcjg	MODE=ind|TEMPS=pst|PERS.=3|NOMB.=s
ꝓpoſe	proposer	VERppe	NOMB.=s|GENRE=m
Dieu	Dieu	NOMpro	NOMB.=s|GENRE=m
en	en	PROadv	MORPH=empty
a	avoir	VERcjg	MODE=ind|TEMPS=pst|PERS.=3|NOMB.=s
touſieurs	toujours	ADVgen	MORPH=empty
diſpoſe	disposer	VERppe	NOMB.=s|GENRE=m
Et	et	CONcoo	MORPH=empty
diſpoſe	disposer	VERcjg	MODE=ind|TEMPS=pst|PERS.=3|NOMB.=s
ſans	sans	PRE	MORPH=empty
plus	plus	ADVgen	MORPH=empty
enquerre	enquérir	VERinf	MORPH=empty
Quant	quand	CONsub	MORPH=empty
querelles	querelle	NOMcom	NOMB.=p|GENRE=f
eſmeuuent	émouvoir	VERcjg	MODE=ind|TEMPS=pst|PERS.=3|NOMB.=p
guerre	guerre	NOMcom	NOMB.=s|GENRE=f
Par	par	PRE	MORPH=empty
champs	champ	NOMcom	NOMB.=p|GENRE=m
on	on	PROper	PERS.=3|NOMB.=s|GENRE=x|CAS=n
uoit	voir	VERcjg	MODE=ind|TEMPS=pst|PERS.=3|NOMB.=s
armes	arme	NOMcom	NOMB.=p|GENRE=f
reluire	reluire	VERinf	MORPH=empty
Le	le	DETdef	NOMB.=s|GENRE=m
petit	petit	NOMcom	NOMB.=s|GENRE=m
peult	pouvoir	VERcjg	MODE=ind|TEMPS=pst|PERS.=3|NOMB.=s
bien	bien	ADVgen	MORPH=empty
au	à_le	PRE.DETdef	NOMB.=s|GENRE=m
grant	grand	NOMcom	NOMB.=s|GENRE=m
nuire	nuire	VERinf	MORPH=empty
Pour	pour	PRE	MORPH=empty
ſimple	simple	ADJqua	NOMB.=s|GENRE=m
cas	cas	NOMcom	NOMB.=s|GENRE=m
ie	je	PROper	PERS.=1|NOMB.=s|GENRE=x|CAS=n
uous	vous	PROper	PERS.=2|NOMB.=p|GENRE=x|CAS=i
prometz	promettre	VERcjg	MODE=ind|TEMPS=pst|PERS.=1|NOMB.=s
Que	que	CONsub	MORPH=empty
aucuneſfois	aucunefois	ADVgen	MORPH=empty
uient	venir	VERcjg	MODE=ind|TEMPS=pst|PERS.=3|NOMB.=s
grant	grand	ADJqua	NOMB.=s|GENRE=m
dommage	dommage	NOMcom	NOMB.=s|GENRE=m
Rigueur	rigueur	NOMcom	NOMB.=s|GENRE=f
en	en	PROadv	MORPH=empty
ſort	sortir	VERcjg	MODE=ind|TEMPS=pst|PERS.=3|NOMB.=s
pour	pour	PRE	MORPH=empty
entremetz	entremets	NOMcom	NOMB.=s|GENRE=m
Tel	tel	PROind	NOMB.=s|GENRE=x
lachepte	lacheter	ADJqua	NOMB.=s|GENRE=m
qui	qui	PROrel	NOMB.=s|GENRE=x
n	ne	ADVneg	MORPH=empty
en	en	PROadv	MORPH=empty
peult	pouvoir	VERcjg	MODE=ind|TEMPS=pst|PERS.=3|NOMB.=s
mais	mais	CONcoo	MORPH=empty
On	on	PROper	PERS.=3|NOMB.=s|GENRE=x|CAS=n
le	il	PROper	PERS.=3|NOMB.=s|GENRE=m|CAS=r
dit	dire	VERcjg	MODE=ind|TEMPS=pst|PERS.=3|NOMB.=s
en	en	PRE	MORPH=empty
commun	commun	ADJqua	NOMB.=s|GENRE=m
langaige	langage	NOMcom	NOMB.=s|GENRE=m
Et	et	CONcoo	MORPH=empty
pource	pour_ce	ADVgen	MORPH=empty
celluy	celui	PROdem	NOMB.=s|GENRE=m
qui	qui	PROrel	NOMB.=s|GENRE=m
est	être	VERcjg	MODE=ind|TEMPS=pst|PERS.=3|NOMB.=s
ſaige	sage	ADJqua	NOMB.=s|GENRE=m
Doit	devoir	VERcjg	MODE=ind|TEMPS=pst|PERS.=3|NOMB.=s
bien	bien	ADVgen	MORPH=empty
noter	noter	VERinf	MORPH=empty
ce	ce	DETdem	NOMB.=s|GENRE=m
mot	mot	NOMcom	NOMB.=s|GENRE=m
pour	pour	PRE	MORPH=empty
preuue	preuve	NOMcom	NOMB.=s|GENRE=f
Qui	qui	PROrel	NOMB.=s|GENRE=x
bien	bien	ADVgen	MORPH=empty
ſe	il	PROper	PERS.=3|NOMB.=s|GENRE=x|CAS=r
garde	garder	VERcjg	MODE=ind|TEMPS=pst|PERS.=3|NOMB.=s
bien	bien	ADVgen	MORPH=empty
ſe	il	PROper	PERS.=3|NOMB.=s|GENRE=x|CAS=r
treuue	trouver	VERcjg	MODE=ind|TEMPS=pst|PERS.=3|NOMB.=s
Le	le	DETdef	NOMB.=s|GENRE=m
plus	plus	ADVgen	MORPH=empty
ſouuent	souvent	ADVgen	MORPH=empty
les	le	DETdef	NOMB.=p|GENRE=m
plus	plus	ADVgen	MORPH=empty
uaillans	vaillant	NOMcom	NOMB.=p|GENRE=m
N	ne	ADVneg	MORPH=empty
ont	avoir	VERcjg	MODE=ind|TEMPS=pst|PERS.=3|NOMB.=p
la	le	DETdef	NOMB.=s|GENRE=f
uictoire	victoire	NOMcom	NOMB.=s|GENRE=f
en	en	PRE	MORPH=empty
la	le	DETdef	NOMB.=s|GENRE=f
bataille	bataille	NOMcom	NOMB.=s|GENRE=f
On	on	PROper	PERS.=3|NOMB.=s|GENRE=x|CAS=n
uoit	voir	VERcjg	MODE=ind|TEMPS=pst|PERS.=3|NOMB.=s
uaillans	vaillant	NOMcom	NOMB.=p|GENRE=m
contre	contre	PRE	MORPH=empty
uaillans	vaillant	NOMcom	NOMB.=p|GENRE=m
Rompre	rompre	VERinf	MORPH=empty
taillans	taillant	NOMcom	NOMB.=p|GENRE=m
contre	contre	PRE	MORPH=empty
taillans	taillant	NOMcom	NOMB.=p|GENRE=m
Laſſer	laisser	VERinf	MORPH=empty
tours	tour	NOMcom	NOMB.=p|GENRE=f
:	:	PONfbl	MORPH=empty
abatre	abattre	VERinf	MORPH=empty
muraille	muraille	NOMcom	NOMB.=s|GENRE=f
Souuent	souvent	ADVgen	MORPH=empty
ſans	sans	PRE	MORPH=empty
crier	crier	VERinf	MORPH=empty
baille	bailler	NOMcom	NOMB.=s|GENRE=f
,	,	PONfbl	MORPH=empty
baille	bailler	NOMcom	NOMB.=s|GENRE=f
Commiſe	commettre	VERppe	NOMB.=s|GENRE=f
par	par	PRE	MORPH=empty
eulx	il	PROper	PERS.=3|NOMB.=p|GENRE=m|CAS=i
et	et	CONcoo	MORPH=empty
l	le	DETdef	NOMB.=s|GENRE=m
oultraige	outrage	NOMcom	NOMB.=s|GENRE=m
Si	si	CONsub	MORPH=empty
par	par	PRE	MORPH=empty
ce	ce	DETdem	NOMB.=s|GENRE=m
moyen	moyen	NOMcom	NOMB.=s|GENRE=m
on	on	PROper	PERS.=3|NOMB.=s|GENRE=x|CAS=n
uoyaige	voyage	VERcjg	MODE=ind|TEMPS=pst|PERS.=3|NOMB.=s
l	le	DETdef	NOMB.=s|GENRE=f
entreprinſe	entreprise	NOMcom	NOMB.=s|GENRE=f
ſera	être	VERcjg	MODE=ind|TEMPS=fut|PERS.=3|NOMB.=s
treſbonne	très_bon	ADJqua	NOMB.=s|GENRE=f
Ainſi	ainsi	ADVgen	MORPH=empty
quon	que_on	CONsub.PROper	PERS.=3|NOMB.=s|GENRE=x|CAS=n
dit	dire	VERcjg	MODE=ind|TEMPS=pst|PERS.=3|NOMB.=s
la	le	DETdef	NOMB.=s|GENRE=f
fin	fin	NOMcom	NOMB.=s|GENRE=f
couronne	couronner	VERcjg	MODE=ind|TEMPS=pst|PERS.=3|NOMB.=s
Toutes	tout	DETind	NOMB.=p|GENRE=f
guerres	guerre	NOMcom	NOMB.=p|GENRE=f
ſont	être	VERcjg	MODE=ind|TEMPS=pst|PERS.=3|NOMB.=p
redoubtables	redoutable	ADJqua	NOMB.=p|GENRE=f
Quant	quand	CONsub	MORPH=empty
orgueil	orgueil	NOMcom	NOMB.=s|GENRE=m
en	en	PROadv	MORPH=empty
eſt	être	VERcjg	MODE=ind|TEMPS=pst|PERS.=3|NOMB.=s
conſentant	consentir	VERppa	NOMB.=s|GENRE=m
Et	et	CONcoo	MORPH=empty
ne	ne	ADVneg	MORPH=empty
acquiert	acquérir	VERcjg	MODE=ind|TEMPS=pst|PERS.=3|NOMB.=s
on	on	PROper	PERS.=3|NOMB.=s|GENRE=x|CAS=n
gloires	gloire	NOMcom	NOMB.=p|GENRE=f
louables	louable	ADJqua	NOMB.=p|GENRE=f
Au	à_le	PRE.DETdef	NOMB.=s|GENRE=m
corps	corps	NOMcom	NOMB.=s|GENRE=m
ne	ni	CONcoo	MORPH=empty
a	à	PRE	MORPH=empty
l	le	DETdef	NOMB.=s|GENRE=f
ame	âme	NOMcom	NOMB.=s|GENRE=f
prouffitables	profitable	ADJqua	NOMB.=p|GENRE=f
Si	si	CONsub	MORPH=empty
ſen	sen	ADVneg	MORPH=empty
droit	droit	NOMcom	NOMB.=s|GENRE=m
on	on	PROper	PERS.=3|NOMB.=s|GENRE=x|CAS=n
ua	aller	VERcjg	MODE=ind|TEMPS=pst|PERS.=3|NOMB.=s
combatant	combattre	VERppa	NOMB.=s|GENRE=x
Mais	mais	CONcoo	MORPH=empty
au	à_le	PRE.DETdef	NOMB.=s|GENRE=m
temps	temps	NOMcom	NOMB.=s|GENRE=m
preſent	présent	ADJqua	NOMB.=s|GENRE=m
le	le	DETdef	NOMB.=s|GENRE=m
contant	contant	VERppa	GENRE=m
faict	fait	VERcjg	MODE=ind|TEMPS=pst|PERS.=3|NOMB.=s
la	le	DETdef	NOMB.=s|GENRE=f
foy	foi	NOMcom	NOMB.=s|GENRE=f
tres	très	ADVgen	MORPH=empty
laſche	lâche	ADJqua	NOMB.=s|GENRE=f
et	et	CONcoo	MORPH=empty
debile	débile	ADJqua	NOMB.=s|GENRE=f
Nobleſſe	noblesse	NOMcom	NOMB.=s|GENRE=f
doit	devoir	VERcjg	MODE=ind|TEMPS=pst|PERS.=3|NOMB.=s
eſtre	être	VERinf	MORPH=empty
ſtabille	stabile	ADJqua	NOMB.=s|GENRE=f
Ce	ce	DETdem	NOMB.=s|GENRE=m
propos	propos	NOMcom	NOMB.=s|GENRE=m
nous	nous	PROper	PERS.=1|NOMB.=p|GENRE=x|CAS=i
conuient	convenir	VERcjg	MODE=ind|TEMPS=pst|PERS.=3|NOMB.=s
laiſſer	laisser	VERinf	MORPH=empty
Dieu	Dieu	NOMpro	NOMB.=s|GENRE=m
vueille	vouloir	VERcjg	NOMB.=s
que	que	CONsub	MORPH=empty
tout	tout	DETind	NOMB.=s|GENRE=m
bien	bien	NOMcom	NOMB.=s|GENRE=m
ſe	il	PROper	PERS.=3|NOMB.=s|GENRE=x|CAS=r
face	faire	VERcjg	MODE=sub|TEMPS=pst|PERS.=3|NOMB.=s
Et	et	CONcoo	MORPH=empty
deſormais	désormais	ADVgen	MORPH=empty
nous	nous	PROper	PERS.=1|NOMB.=p|GENRE=x|CAS=i
ſault	falloir	VERcjg	MODE=ind|TEMPS=pst|PERS.=3|NOMB.=s
penſer	penser	VERinf	MORPH=empty
Si	si	CONsub	MORPH=empty
poſſible	possible	ADJqua	NOMB.=s|GENRE=n
eſt	être	VERcjg	MODE=ind|TEMPS=pst|PERS.=3|NOMB.=s
recommencer	recommencer	VERinf	MORPH=empty
Aller	aller	VERinf	MORPH=empty
paſſer	passer	VERinf	MORPH=empty
temps	temps	NOMcom	NOMB.=s|GENRE=m
a	à	PRE	MORPH=empty
la	le	DETdef	NOMB.=s|GENRE=f
chaſſe	chasse	NOMcom	NOMB.=s|GENRE=f
Nobleſſe	noblesse	NOMcom	NOMB.=s|GENRE=f
tel	tel	DETind	NOMB.=s|GENRE=m
eſtat	état	NOMcom	NOMB.=s|GENRE=m
pourchaſſe	pourchasser	VERcjg	MODE=ind|TEMPS=pst|PERS.=3|NOMB.=s
Et	et	CONcoo	MORPH=empty
nompas	non_pas	ADVneg	MORPH=empty
guerres	guerre	NOMcom	NOMB.=p|GENRE=f
et	et	CONcoo	MORPH=empty
debatz	débat	NOMcom	NOMB.=p|GENRE=m
Selon	selon	PRE	MORPH=empty
le	le	DETdef	NOMB.=s|GENRE=m
temps	temps	NOMcom	NOMB.=s|GENRE=m
ſont	être	VERcjg	MODE=ind|TEMPS=pst|PERS.=3|NOMB.=p
les	le	DETdef	NOMB.=p|GENRE=m
eſbatz	ébat	NOMcom	NOMB.=p|GENRE=m
Quant	quand	CONsub	MORPH=empty
les	le	DETdef	NOMB.=p|GENRE=m
cerfz	cerf	NOMcom	NOMB.=p|GENRE=m
ſont	être	VERcjg	MODE=ind|TEMPS=pst|PERS.=3|NOMB.=p
en	en	PRE	MORPH=empty
uenoiſon	venaison	NOMcom	NOMB.=s|GENRE=f
Fiertez	fierté	NOMcom	NOMB.=p|GENRE=f
monſtrent	montrer	VERcjg	MODE=ind|TEMPS=pst|PERS.=3|NOMB.=p
et	et	CONcoo	MORPH=empty
arrogances	arrogance	NOMcom	NOMB.=p|GENRE=f
Et	et	CONcoo	MORPH=empty
n	ne	ADVneg	MORPH=empty
y	y	PROadv	MORPH=empty
a	avoir	VERcjg	MODE=ind|TEMPS=pst|PERS.=3|NOMB.=s
rime	rime	NOMcom	NOMB.=s|GENRE=f
ne	ni	CONcoo	MORPH=empty
raiſon	raison	NOMcom	NOMB.=s|GENRE=f
En	en	PRE	MORPH=empty
iceulx	icelui	PROdem	NOMB.=p|GENRE=m
durant	durant	PRE	MORPH=empty
la	le	DETdef	NOMB.=s|GENRE=f
ſaiſon	saison	NOMcom	NOMB.=s|GENRE=f
Mais	mais	CONcoo	MORPH=empty
que	que	PROrel	MORPH=empty
nous	nous	PROper	PERS.=1|NOMB.=p|GENRE=x|CAS=n
entendons	entendre	VERcjg	MODE=ind|TEMPS=pst|PERS.=1|NOMB.=p
leur	leur	DETpos	PERS.=3|NOMB.=s|GENRE=m
change	change	NOMcom	NOMB.=s|GENRE=m
Souuent	souvent	ADVgen	MORPH=empty
repoſent	reposer	VERcjg	MODE=ind|TEMPS=pst|PERS.=3|NOMB.=p
a	à	PRE	MORPH=empty
la	le	DETdef	NOMB.=s|GENRE=f
fange	fange	NOMcom	NOMB.=s|GENRE=f
En	en	PRE	MORPH=empty
la	le	DETdef	NOMB.=s|GENRE=f
riuiere	rivière	NOMcom	NOMB.=s|GENRE=f
ou	ou	CONcoo	MORPH=empty
en	en	PRE	MORPH=empty
eſtangs	étang	NOMcom	NOMB.=p|GENRE=m
A	à	PRE	MORPH=empty
bien	bien	ADVgen	MORPH=empty
parler	parler	VERinf	MORPH=empty
cerfz	cerf	NOMcom	NOMB.=p|GENRE=m
ne	ne	ADVneg	MORPH=empty
ſont	être	VERcjg	MODE=ind|TEMPS=pst|PERS.=3|NOMB.=p
francs	franc	ADJqua	NOMB.=p|GENRE=m
Long	long	ADJqua	NOMB.=s|GENRE=m
temps	temps	NOMcom	NOMB.=s|GENRE=m
y	y	PROadv	MORPH=empty
a	avoir	VERcjg	MODE=ind|TEMPS=pst|PERS.=3|NOMB.=p
ie	je	PROper	PERS.=1|NOMB.=s|GENRE=x|CAS=n
m	je	PROper	PERS.=1|NOMB.=s|GENRE=x|CAS=r
en	en	PROadv	MORPH=empty
recorde	recorder	VERcjg	MODE=ind|TEMPS=pst|PERS.=1|NOMB.=s
,	,	PONfbl	MORPH=empty
Quil	que_il	CONsub.PROimp	PERS.=0|NOMB.=s|GENRE=n|CAS=n
uint	venir	VERcjg	MODE=ind|TEMPS=psp|PERS.=3|NOMB.=s
des	de_le	PRE.DETdef	NOMB.=p|GENRE=m
cerfz	cerf	NOMcom	NOMB.=p|GENRE=m
deuant	devant	PRE	MORPH=empty
nancy	Nancy	NOMpro	NOMB.=s|GENRE=x
Plains	plein	ADJqua	NOMB.=p|GENRE=m
de	de	PRE	MORPH=empty
rigueur	rigueur	NOMcom	NOMB.=s|GENRE=f
hayant	hayant	VERppa	MORPH=empty
concorde	concorde	NOMcom	NOMB.=s|GENRE=f
Qui	qui	PROrel	NOMB.=p|GENRE=m
uoulurent	vouloir	VERcjg	MODE=ind|TEMPS=psp|PERS.=3|NOMB.=p
prendre	prendre	VERinf	MORPH=empty
diſcorde	discorde	NOMcom	NOMB.=s|GENRE=f
A	à	PRE	MORPH=empty
ung	un	DETndf	NOMB.=s|GENRE=m
ieune	jeune	ADJqua	NOMB.=s|GENRE=m
ueneur	veneur	NOMcom	NOMB.=s|GENRE=m
,	,	PONfbl	MORPH=empty
auſſi	aussi	ADVgen	MORPH=empty
Il	il	PROper	PERS.=3|NOMB.=s|GENRE=m|CAS=n
leur	il	PROper	PERS.=3|NOMB.=p|GENRE=m|CAS=i
en	en	PROadv	MORPH=empty
print	prendre	VERcjg	MODE=ind|TEMPS=psp|PERS.=3|NOMB.=s
mal	mal	ADVgen	MORPH=empty
dieu	dieu	NOMcom	NOMB.=s|GENRE=m
mercy	merci	NOMcom	NOMB.=s|GENRE=f
Le	le	DETdef	NOMB.=s|GENRE=m
fief	fief	ADJqua	NOMB.=s|GENRE=m
cerf	cerf	NOMcom	NOMB.=s|GENRE=m
au	à_le	PRE.DETdef	NOMB.=s|GENRE=m
ruiſſeau	ruisseau	NOMcom	NOMB.=s|GENRE=m
mourut	mourir	VERcjg	MODE=ind|TEMPS=psp|PERS.=3|NOMB.=s
Car	car	CONcoo	MORPH=empty
dieu	dieu	NOMcom	NOMB.=s|GENRE=m
le	le	DETdef	NOMB.=s|GENRE=m
ueneur	veneur	NOMcom	NOMB.=s|GENRE=m
ſecourut	secourir	VERcjg	MODE=ind|TEMPS=psp|PERS.=3|NOMB.=s
Les	le	DETdef	NOMB.=p|GENRE=m
cerfz	cerf	NOMcom	NOMB.=p|GENRE=m
D	de	PRE	MORPH=empty
ardanne	Ardennes	NOMpro	NOMB.=p|GENRE=f
courent	courir	VERcjg	MODE=ind|TEMPS=pst|PERS.=3|NOMB.=p
fort	fort	ADVgen	MORPH=empty
Cuyr	cuir	NOMcom	NOMB.=s|GENRE=m
ont	avoir	VERcjg	MODE=ind|TEMPS=pst|PERS.=3|NOMB.=p
ferme	ferme	ADJqua	NOMB.=s|GENRE=m
et	et	CONcoo	MORPH=empty
les	le	DETdef	NOMB.=p|GENRE=f
teſtes	tête	NOMcom	NOMB.=p|GENRE=f
dures	dur	ADJqua	NOMB.=p|GENRE=f
Mais	mais	CONcoo	MORPH=empty
quant	quand	CONsub	MORPH=empty
l	le	DETdef	NOMB.=s|GENRE=m
ung	un	PROind	NOMB.=s|GENRE=m
des	de_le	PRE.DETdef	NOMB.=p|GENRE=m
cerfz	cerf	NOMcom	NOMB.=p|GENRE=m
du	de_le	PRE.DETdef	NOMB.=s|GENRE=m
boys	bois	NOMcom	NOMB.=s|GENRE=m
ſort	sortir	VERcjg	MODE=ind|TEMPS=pst|PERS.=3|NOMB.=s
On	on	PROper	PERS.=3|NOMB.=s|GENRE=x|CAS=n
en	en	PROadv	MORPH=empty
peult	pouvoir	VERcjg	MODE=ind|TEMPS=pst|PERS.=3|NOMB.=s
faire	faire	VERinf	MORPH=empty
le	le	DETdef	NOMB.=s|GENRE=m
rapport	rapport	NOMcom	NOMB.=s|GENRE=m
Du	de_le	PRE.DETdef	NOMB.=s|GENRE=m
pied	pied	NOMcom	NOMB.=s|GENRE=m
de	de	PRE	MORPH=empty
la	la	DETdef	NOMB.=s|GENRE=f
marche	marche	NOMcom	NOMB.=s|GENRE=f
ou	ou	CONcoo	MORPH=empty
rammeures	ramure	NOMcom	NOMB.=p|GENRE=f
Par	par	PRE	MORPH=empty
deliberations	délibération	NOMcom	NOMB.=p|GENRE=f
meures	mûr	ADJqua	NOMB.=p|GENRE=f
Treuue	trouver	VERcjg	MODE=ind|TEMPS=pst|PERS.=3|NOMB.=s
le	le	DETdef	NOMB.=s|GENRE=m
moyen	moyen	NOMcom	NOMB.=s|GENRE=m
et	et	CONcoo	MORPH=empty
facon	façon	NOMcom	NOMB.=s|GENRE=f
Soy	il	PROper	PERS.=3|NOMB.=s|GENRE=m|CAS=r
retirer	retirer	VERinf	MORPH=empty
en	en	PRE	MORPH=empty
ſon	son	DETpos	PERS.=3|NOMB.=s|GENRE=m
buiſſon	buisson	NOMcom	NOMB.=s|GENRE=m
Des	de_le	PRE.DETdef	NOMB.=p|GENRE=m
cerfz	cerf	NOMcom	NOMB.=p|GENRE=m
on	on	PROper	PERS.=3|NOMB.=s|GENRE=x|CAS=n
treuue	trouver	VERcjg	MODE=ind|TEMPS=pst|PERS.=3|NOMB.=s
aucuneffois	aucunefois	ADVgen	MORPH=empty
Qui	qui	PROrel	NOMB.=p|GENRE=m
ne	ne	ADVneg	MORPH=empty
uallent	valoir	VERcjg	MODE=ind|TEMPS=pst|PERS.=3|NOMB.=p
pas	pas	ADVneg	MORPH=empty
que	que	CONsub	MORPH=empty
on	on	PROper	PERS.=3|NOMB.=s|GENRE=x|CAS=n
les	il	PROper	PERS.=3|NOMB.=p|GENRE=m|CAS=r
chaſſe	chasser	VERcjg	MODE=sub|TEMPS=pst|PERS.=3|NOMB.=s
Et	et	CONcoo	MORPH=empty
ſi	si	CONsub	MORPH=empty
taſchent	tâcher	VERcjg	MODE=ind|TEMPS=pst|PERS.=3|NOMB.=p
auoir	avoir	VERinf	MORPH=empty
le	le	DETdef	NOMB.=s|GENRE=m
chois	choix	NOMcom	NOMB.=s|GENRE=m
Des	de_le	PRE.DETdef	NOMB.=p|GENRE=m
buiſſons	buisson	NOMcom	NOMB.=p|GENRE=m
ſont	être	VERcjg	MODE=ind|TEMPS=pst|PERS.=3|NOMB.=p
cerſz	cerf	NOMcom	NOMB.=p|GENRE=m
mal	mal	ADVgen	MORPH=empty
courtois	courtois	ADJqua	NOMB.=p|GENRE=m
Dont	dont	PROrel	NOMB.=s|GENRE=x
la	le	DETdef	NOMB.=s|GENRE=f
foreſt	forêt	NOMcom	NOMB.=s|GENRE=f
franche	franc	ADJqua	NOMB.=s|GENRE=f
on	on	PROper	PERS.=3|NOMB.=s|GENRE=x|CAS=n
eſbranche	ébrancher	VERcjg	MODE=ind|TEMPS=pst|PERS.=3|NOMB.=s
La	il	PROper	PERS.=3|NOMB.=s|GENRE=f|CAS=r
uoulant	vouloir	VERppa	NOMB.=s|GENRE=x
porter	porter	VERinf	MORPH=empty
branche	branche	NOMcom	NOMB.=s|GENRE=f
a	à	PRE	MORPH=empty
branche	branche	NOMcom	NOMB.=s|GENRE=f
En	en	PRE	MORPH=empty
une	un	DETndf	NOMB.=s|GENRE=f
foreſt	forêt	NOMcom	NOMB.=s|GENRE=f
qui	qui	PROrel	NOMB.=s|GENRE=f
eſt	être	VERcjg	MODE=ind|TEMPS=pst|PERS.=3|NOMB.=s
loing	loin	ADVgen	MORPH=empty
Bon	bon	ADJqua	NOMB.=s|GENRE=m
droit	droit	NOMcom	NOMB.=s|GENRE=m
de	de	PRE	MORPH=empty
bonne	bon	ADJqua	NOMB.=s|GENRE=f
ayde	aide	NOMcom	NOMB.=s|GENRE=f
a	avoir	VERcjg	MODE=ind|TEMPS=pst|PERS.=3|NOMB.=s
beſoing	besoin	NOMcom	NOMB.=s|GENRE=m
Si	si	CONsub	MORPH=empty
le	le	DETdef	NOMB.=s|GENRE=m
ueneur	veneur	NOMcom	NOMB.=s|GENRE=m
faict	faire	VERcjg	MODE=ind|TEMPS=pst|PERS.=3|NOMB.=s
des	de_le	PRE.DETdef	NOMB.=p|GENRE=m
tailliz	taillis	NOMcom	NOMB.=p|GENRE=m
De	de	PRE	MORPH=empty
ſes	son	DETpos	PERS.=2|NOMB.=p
fortz	fort	NOMcom	NOMB.=p|GENRE=m
c	ce	PROdem	NOMB.=s|GENRE=n
eſt	être	VERcjg	MODE=ind|TEMPS=pst|PERS.=3|NOMB.=s
en	en	PRE	MORPH=empty
eſperance	espérance	NOMcom	NOMB.=s|GENRE=f
Que	que	CONsub	MORPH=empty
ces	ce	DETdem	NOMB.=p|GENRE=m
cerfz	cerf	NOMcom	NOMB.=p|GENRE=m
n	ne	ADVneg	MORPH=empty
auront	avoir	VERcjg	MODE=ind|TEMPS=fut|PERS.=3|NOMB.=p
cueurs	cœur	NOMcom	NOMB.=p|GENRE=m
failliz	faillir	VERppe	NOMB.=p|GENRE=m
Enclorre	enclore	VERcjg	MODE=ind|TEMPS=pst|PERS.=3|NOMB.=s
en	en	PRE	MORPH=empty
brief	bref	ADJqua	NOMB.=s|GENRE=m
temps	temps	NOMcom	NOMB.=s|GENRE=m
de	de	PRE	MORPH=empty
paliz	palis	NOMcom	NOMB.=p|GENRE=m
L	la	DETdef	NOMB.=s|GENRE=f
eſtrange	étrange	ADJqua	NOMB.=s|GENRE=f
foreſt	forêt	NOMcom	NOMB.=s|GENRE=f
par	par	PRE	MORPH=empty
puiſſance	puissance	NOMcom	NOMB.=s|GENRE=f
Puis	puis	ADVgen	MORPH=empty
de	de	PRE	MORPH=empty
ſes	son	DETdem	NOMB.=p|GENRE=m
tailliz	taillis	NOMcom	NOMB.=p|GENRE=m
habondance	abondance	NOMcom	NOMB.=s|GENRE=f
Haultes	haut	ADJqua	NOMB.=p|GENRE=f
fuſtayes	futaie	NOMcom	NOMB.=p|GENRE=f
baſtira	bâtir	VERcjg	MODE=ind|TEMPS=fut|PERS.=3|NOMB.=s
Qui	qui	PROrel	NOMB.=s|GENRE=x
penſe	penser	VERcjg	MODE=ind|TEMPS=pst|PERS.=3|NOMB.=s
bien	bien	ADVgen	MORPH=empty
,	,	PONfbl	MORPH=empty
bien	bien	ADVgen	MORPH=empty
ſentira	sentir	VERcjg	MODE=ind|TEMPS=fut|PERS.=3|NOMB.=s
.	.	PONfrt	MORPH=empty
Dieu	Dieu	NOMpro	NOMB.=s|GENRE=m
le	le	DETdef	NOMB.=s|GENRE=m
cueur	cœur	NOMcom	NOMB.=s|GENRE=m
du	de_le	PRE.DETdef	NOMB.=s|GENRE=m
ueneur	veneur	NOMcom	NOMB.=s|GENRE=m
inſpire	inspirer	VERcjg	MODE=ind|TEMPS=pst|PERS.=3|NOMB.=s
Car	car	CONcoo	MORPH=empty
il	il	PROper	PERS.=3|NOMB.=s|GENRE=m|CAS=n
le	il	PROper	PERS.=3|NOMB.=s|GENRE=m|CAS=r
tient	tenir	VERcjg	MODE=ind|TEMPS=pst|PERS.=3|NOMB.=s
dedans	dedans	PRE	MORPH=empty
ſa	son	DETpos	PERS.=3|NOMB.=s|GENRE=f
main	main	NOMcom	NOMB.=s|GENRE=f
Et	et	CONcoo	MORPH=empty
ſi	si	CONsub	MORPH=empty
contre	contre	PRE	MORPH=empty
luy	il	PROper	PERS.=3|NOMB.=s|GENRE=m|CAS=i
lon	le_on	PROind	PERS.=3|NOMB.=s|GENRE=x|CAS=n
conſpire	conspirer	VERcjg	MODE=ind|TEMPS=pst|PERS.=3|NOMB.=s
Conſpirateurs	conspirateur	NOMcom	NOMB.=p|GENRE=m
auront	avoir	VERcjg	MODE=ind|TEMPS=fut|PERS.=3|NOMB.=p
du	de_le	PRE.DETdef	NOMB.=s|GENRE=m
pire	pire	NOMcom	NOMB.=s|GENRE=m
Se	si	CONsub	MORPH=empty
en	en	PRE	MORPH=empty
conſpirant	conspirer	VERppa	NOMB.=p|GENRE=m
ont	avoir	VERcjg	MODE=ind|TEMPS=pst|PERS.=3|NOMB.=p
le	le	DETdef	NOMB.=s|GENRE=m
cueur	cœur	NOMcom	NOMB.=s|GENRE=m
uain	vain	ADJqua	NOMB.=s|GENRE=m
Et	et	CONcoo	MORPH=empty
fauldra	falloir	VERcjg	MODE=ind|TEMPS=fut|PERS.=3|NOMB.=s
que	que	CONsub	MORPH=empty
cueur	cœur	NOMcom	NOMB.=s|GENRE=m
inhumain	inhumain	ADJqua	NOMB.=s|GENRE=m
Le	le	DETdef	NOMB.=s|GENRE=m
ueneur	veneur	NOMcom	NOMB.=s|GENRE=m
monſtre	montrer	VERcjg	MODE=ind|TEMPS=pst|PERS.=3|NOMB.=s
quoy	quoi	PROrel	NOMB.=s|GENRE=n
quil	que_il	PROrel.PROimp	PERS.=0|NOMB.=s|GENRE=n|CAS=n
couſte	coûter	VERcjg	MODE=ind|TEMPS=pst|PERS.=3|NOMB.=s|GENRE=f
Toute	tout	DETind	NOMB.=s|GENRE=f
entrepriſe	entreprise	NOMcom	NOMB.=s|GENRE=f
giſt	gésir	VERcjg	MODE=ind|TEMPS=pst|PERS.=3|NOMB.=s
en	en	PRE	MORPH=empty
doubte	doute	NOMcom	NOMB.=s|GENRE=f
.	.	PONfrt	MORPH=empty
A	à	PRE	MORPH=empty
ceſte	ce	DETdem	NOMB.=s|GENRE=f
chaſſe	chasse	NOMcom	NOMB.=s|GENRE=f
penſerons	penser	VERcjg	MODE=ind|TEMPS=fut|PERS.=1|NOMB.=p
Et	et	CONcoo	MORPH=empty
ſur	sur	PRE	MORPH=empty
le	le	DETdef	NOMB.=s|GENRE=m
texte	texte	NOMcom	NOMB.=s|GENRE=m
mettrons	mettre	ADJqua	MODE=ind|TEMPS=fut|PERS.=1|NOMB.=p
gloſe	glose	NOMcom	NOMB.=s|GENRE=f
Quant	quand	CONsub	MORPH=empty
ſes	son	DETdem	NOMB.=p|GENRE=m
mots	mot	NOMcom	NOMB.=p|GENRE=m
conſidererons	considérer	VErcjg	MODE=ind|TEMPS=fut|PERS.=1|NOMB.=p
En	en	PRE	MORPH=empty
noſtre	notre	DETpos	PERS.=1|NOMB.=s|GENRE=m
cueur	cœur	NOMcom	NOMB.=s|GENRE=m
les	il	PROper	PERS.=3|NOMB.=p|GENRE=m|CAS=r
noterons	noter	VERcjg	MODE=ind|TEMPS=fut|PERS.=1|NOMB.=p
Se	si	CONsub	MORPH=empty
neſt	ne_être	VERcjg	MODE=ind|TEMPS=pst|PERS.=3|NOMB.=s
pas	pas	ADVneg	MORPH=empty
trop	trop	ADVgen	MORPH=empty
commune	commun	ADJqua	NOMB.=s|GENRE=f
choſe	chose	NOMcom	NOMB.=s|GENRE=f
Chaſſer	chasser	VERinf	MORPH=empty
ſouuent	souvent	ADVgen	MORPH=empty
on	on	PROper	PERS.=3|NOMB.=s|GENRE=x|CAS=n
ſe	il	PROper	PERS.=3|NOMB.=s|GENRE=x|CAS=r
diſpoſe	disposer	VERcjg	MODE=ind|TEMPS=pst|PERS.=3|NOMB.=s
Et	et	CONcoo	MORPH=empty
ſi	si	CONsub	MORPH=empty
couſte	coûter	VERcjg	MODE=sub|TEMPS=pst|PERS.=3|NOMB.=s
cher	cher	ADVgen	MORPH=empty
uiſion	vision	NOMcom	NOMB.=s|GENRE=f
Il	il	PROimp	PERS.=0|NOMB.=s|GENRE=n|CAS=n
fault	falloir	VERcjg	MODE=ind|TEMPS=pst|PERS.=3|NOMB.=s
auoir	avoir	VERinf	MORPH=empty
par	par	PRE	MORPH=empty
tout	tout	PROind	NOMB.=s|GENRE=n
raiſon	raison	NOMcom	NOMB.=s|GENRE=f
Menus	menu	ADJqua	NOMB.=p|GENRE=m
propos	propos	NOMcom	NOMB.=p|GENRE=m
ſur	sur	PRE	MORPH=empty
la	le	DETdef	NOMB.=s|GENRE=f
chaſſe	chasse	NOMcom	NOMB.=s|GENRE=f
du	de_le	PRE.DETdef	NOMB.=s|GENRE=m
ſanglier	sanglier	NOMcom	NOMB.=s|GENRE=m
moraliſee	moraliser	VERppe	NOMB.=s|GENRE=f
.	.	PONfrt	MORPH=empty
IE	je	PROper	PERS.=1|NOMB.=s|GENRE=x|CAS=n
ueis	voir	VERcjg	MODE=ind|TEMPS=pst|PERS.=1|NOMB.=s
la	le	DETdef	NOMB.=s|GENRE=f
paix	paix	NOMcom	NOMB.=s|GENRE=f
regner	régner	VERinf	MORPH=empty
pour	pour	PRE	MORPH=empty
une	un	DETndf	NOMB.=s|GENRE=f
eſpaſſe	espace	NOMcom	NOMB.=s|GENRE=f
Par	par	PRE	MORPH=empty
le	le	DETdef	NOMB.=s|GENRE=m
uouloir	vouloir	NOMco	NOMB.=s|GENRE=m
diuin	divin	ADJqua	NOMB.=s|GENRE=m
qui	qui	PROrel	NOMB.=s|GENRE=m
tout	tout	PROind	NOMB.=s|GENRE=n
compaſſe	compasser	VERcjg	MODE=ind|TEMPS=pst|PERS.=3|NOMB.=s
Pan	Pan	NOMpro	NOMB.=s|GENRE=m
faiſoit	faire	VERcjg	MODE=ind|TEMPS=ipf|PERS.=3|NOMB.=s
lors	lors	ADVgen	MORPH=empty
ſes	son	DETdem	NOMB.=p|GENRE=m
armonicques	harmonique	ADJqua	NOMB.=p|GENRE=m
chantz	chant	NOMcom	NOMB.=p|GENRE=m
Simples	simple	ADJqua	NOMB.=p|GENRE=m
bergiers	berger	NOMcom	NOMB.=p|GENRE=m
et	et	CONcoo	MORPH=empty
de	de	PRE	MORPH=empty
ruſticque	rustique	ADJqua	NOMB.=s|GENRE=f
race	race	NOMcom	NOMB.=s|GENRE=f
Par	par	PRE	MORPH=empty
prez	pré	NOMcom	NOMB.=p|GENRE=m
et	et	CONcoo	MORPH=empty
boys	bois	NOMcom	NOMB.=p|GENRE=m
donnerent	donner	VERcjg	MODE=ind|TEMPS=psp|PERS.=3|NOMB.=p
grant	grand	ADJqua	NOMB.=s|GENRE=f
audace	audace	NOMcom	NOMB.=s|GENRE=f
Aux	à_le	PRE.DETdef	NOMB.=p|GENRE=m
fauniens	faunien	NOMcom	NOMB.=p|GENRE=m
que	que	PROrel	NOMB.=p|GENRE=m
diſons	dire	VERcjg	MODE=ind|TEMPS=pst|PERS.=1|NOMB.=p
dieux	dieu	NOMcom	NOMB.=p|GENRE=m
des	de_le	PRE.DETdef	NOMB.=p|GENRE=m
chãps	champ	NOMcom	NOMB.=p|GENRE=m
Mais	mais	CONcoo	MORPH=empty
mars	Mars	NOMpro	NOMB.=s|GENRE=m
miſt	mettre	VERcjg	MODE=ind|TEMPS=psp|PERS.=3|NOMB.=s
ſus	sus	PRE	MORPH=empty
un	un	DETndf	NOMB.=s|GENRE=m
tas	tas	NOMcom	NOMB.=s|GENRE=m
ď	de	PRE	MORPH=empty
gẽs	gent	NOMcom	NOMB.=p|GENRE=m
meſchãs	méchant	ADJqua	NOMB.=p|GENRE=m
Qui	qui	PROrel	NOMB.=p|GENRE=m
aux	à_le	PRE.DETdef	NOMB.=p|GENRE=m
buiſſons	buisson	NOMcom	NOMB.=p|GENRE=m
ſecretz	secret	ADJqua	NOMB.=p|GENRE=m
ſe	il	PROper	PERS.=3|NOMB.=p|GENRE=m|CAS=r
latiterent	latiter	VERcjg	MODE=ind|TEMPS=psp|PERS.=3|NOMB.=p
Et	et	CONcoo	MORPH=empty
ſans	sans	PRE	MORPH=empty
le	le	DETdef	NOMB.=s|GENRE=m
ſceu	su	NOMcom	NOMB.=s|GENRE=m
de	de	PRE	MORPH=empty
Minerue	Minerve	NOMpro	NOMB.=s|GENRE=f
inciterent	inciter	VERcjg	MODE=ind|TEMPS=psp|PERS.=3|NOMB.=p
Pluſieurs	plusieurs	DETind	NOMB.=p|GENRE=m
chaſſeurs	chasseur	NOMcom	NOMB.=p|GENRE=m
a	à	PRE	MORPH=empty
prendre	prendre	VERinf	MORPH=empty
uenoiſon	venaison	NOMcom	NOMB.=s|GENRE=f
Quãt	quand	CONsub	MORPH=empty
par	par	PRE	MORPH=empty
les	le	DETdef	NOMB.=p|GENRE=m
boys	bois	NOMcom	NOMB.=p|GENRE=m
et	et	CONcoo	MORPH=empty
buyſſõs	buisson	NOMcom	NOMB.=p|GENRE=m
ſ	il	PROper	PERS.=3|NOMB.=p|GENRE=m|CAS=r
aſſemblerẽt	assembler	VERcjg	MODE=ind|TEMPS=psp|PERS.=3|NOMB.=p
Les	le	DETdef	NOMB.=p|GENRE=m
gens	gens	NOMcom	NOMB.=p|GENRE=m
de	de	PRE	MORPH=empty
paix	paix	NOMcom	NOMB.=s|GENRE=f
et	et	CONcoo	MORPH=empty
ſes	son	DETdem	PERS.=3|NOMB.=p|GENRE=m
amys	ami	NOMcom	NOMB.=p|GENRE=m
troublerent	troubler	VERcjg	MODE=ind|TEMPS=psp|PERS.=3|NOMB.=p
Plus	plus	ADVgen	MORPH=empty
que	que	CONsub	MORPH=empty
de	de	PRE	MORPH=empty
Medee	Médée	NOMpro	NOMB.=s|GENRE=f
au	à_le	PRE.DETdef	NOMB.=s|GENRE=m
depart	départ	NOMcom	NOMB.=s|GENRE=m
de	de	PRE	MORPH=empty
Iaſon	Jason	NOMpro	NOMB.=s|GENRE=m
Tel	tel	DETind	NOMB.=s|GENRE=m
eſt	être	VERcjg	MODE=ind|TEMPS=pst|PERS.=3|NOMB.=s
grant	grand	ADJind	NOMB.=s|GENRE=m
clerc	clerc	NOMcom	NOMB.=s|GENRE=m
qui	qui	PROrel	NOMB.=s|GENRE=m
ne	ne	ADVneg	MORPH=empty
uſe	user	VERcjg	MODE=ind|TEMPS=pst|PERS.=3|NOMB.=s
de	de	PRE	MORPH=empty
raiſon	raison	NOMcom	NOMB.=s|GENRE=f
Demogorgon	Démogorgon	NOMpro	NOMB.=s|GENRE=m
print	prendre	VERppe	MODE=ind|TEMPS=psp|PERS.=3|NOMB.=s
a	à	PRE	MORPH=empty
Lahos	Lahos	NOMpro	NOMB.=s|GENRE=m
diſcord	discord	NOMcom	NOMB.=s|GENRE=m
Les	le	DETdef	NOMB.=p|GENRE=m
elemenes	élément	NOMcom	NOMB.=p|GENRE=m
ne	ne	ADVneg	MORPH=empty
peurent	pouvoir	VERcjg	MODE=ind|TEMPS=psp|PERS.=3|NOMB.=p
faire	faire	VERinf	MORPH=empty
accord	accord	NOMcom	NOMB.=s|GENRE=m
Chaſcun	chacun	DETind	NOMB.=s|GENRE=m
d	de	PRE	MORPH=empty
iceulx	icelui	PROdem	NOMB.=p|GENRE=m
ſe	il	PROper	PERS.=3|NOMB.=p|GENRE=m|CAS=r
diſoit	dire	VERcjg	MODE=ind|TEMPS=ipf|PERS.=3|NOMB.=s
ſans	sans	PRE	MORPH=empty
droicture	droiture	NOMcom	NOMB.=s|GENRE=f
Premier	premier	DETord	NOMB.=s|GENRE=m
moteur	moteur	NOMcom	NOMB.=s|GENRE=m
:	:	PONfbl	MORPH=empty
fuſt	être	VERcjg	MODE=ind|TEMPS=psp|PERS.=3|NOMB.=s
a	à	PRE	MORPH=empty
droit	droit	NOMcom	NOMB.=s|GENRE=m
ou	ou	CONcoo	MORPH=empty
a	à	PRE	MORPH=empty
tort	tort	NOMcom	NOMB.=s|GENRE=m
Eternite	éternité	NOMcom	NOMB.=s|GENRE=f
qui	qui	PROrel	NOMB.=s|GENRE=f
bruſle	brûler	VERcjg	MODE=ind|TEMPS=pst|PERS.=3|NOMB.=s
:	:	PONfbl	MORPH=empty
rompt	rompre	VERcjg	MODE=ind|TEMPS=pst|PERS.=3|NOMB.=s
:	:	PONfbl	MORPH=empty
ou	ou	CONcoo	MORPH=empty
tord	tordre	VERcjg	MODE=ind|TEMPS=pst|PERS.=3|NOMB.=s
Ce	ce	PROdem	NOMB.=s|GENRE=n
qui	qui	PROrel	NOMB.=s|GENRE=n
luy	il	PROper	PERS.=3|NOMB.=s|GENRE=f|CAS=i
plaiſt	plaire	VERcjg	MODE=ind|TEMPS=pst|PERS.=3|NOMB.=s
allegua	alléguer	VERcjg	MODE=ind|TEMPS=psp|PERS.=3|NOMB.=s
leur	leur	DETpos	PERS.=3|NOMB.=s|GENRE=f
nature	nature	NOMcom	NOMB.=s|GENRE=f
Et	et	CONcoo	MORPH=empty
que	que	CONsub	MORPH=empty
la	le	DETdef	NOMB.=s|GENRE=f
terre	terre	NOMcom	NOMB.=s|GENRE=f
auoit	avoir	VERcjg	MODE=ind|TEMPS=ipf|PERS.=3|NOMB.=s
la	le	DETdef	NOMB.=s|GENRE=f
couuerture	couverture	NOMcom	NOMB.=s|GENRE=f
Par	par	PRE	MORPH=empty
ſon	son	DETpos	PERS.=3|NOMB.=s|GENRE=m
moyen	moyen	NOMcom	NOMB.=s|GENRE=m
mer	mer	NOMcom	NOMB.=s|GENRE=f
nourriſſoit	nourrir	VERcjg	MODE=ind|TEMPS=ipf|PERS.=3|NOMB.=s
poiſſons	poisson	NOMcom	NOMB.=p|GENRE=m
Oyſeaulx	oiseau	NOMcom	NOMB.=p|GENRE=m
en	en	PRE	MORPH=empty
l	le	DETdef	NOMB.=s|GENRE=m
air	air	NOMcom	NOMB.=s|GENRE=m
par	par	PRE	MORPH=empty
diuerſes	divers	ADJqua	NOMB.=p|GENRE=f
faſſons	façon	NOMcom	NOMB.=p|GENRE=f
Auoir	avoir	VERinf	MORPH=empty
crees	créer	VERppe	NOMB.=p|GENRE=f
:	:	PONfbl	MORPH=empty
auſſi	aussi	ADVgen	MORPH=empty
les	le	DETdef	NOMB.=p|GENRE=m
elements	élément	NOMcom	NOMB.=p|GENRE=m
Pour	pour	PRE	MORPH=empty
ſon	son	DETpos	PERS.=3|NOMB.=s|GENRE=m
plaiſir	plaisir	NOMcom	NOMB.=s|GENRE=m
faiſoit	faire	VERcjg	MODE=ind|TEMPS=ipf|PERS.=3|NOMB.=s
:	:	PONfbl	MORPH=empty
neiges	neige	NOMcom	NOMB.=p|GENRE=f
:	:	PONfbl	MORPH=empty
glaſſons	glaçon	NOMcom	NOMB.=p|GENRE=m
Et	et	CONcoo	MORPH=empty
ſouſtenoit	soutenir	VERcjg	MODE=ind|TEMPS=ipf|PERS.=3|NOMB.=s
tous	tout	DETind	NOMB.=p|GENRE=m
humains	humain	NOMcom	NOMB.=p|GENRE=m
:	:	PONfbl	MORPH=empty
or	or	CONcoo	GENRE=m
penſons	penser	NOMcom	MODE=ind|TEMPS=pst|PERS.=1|NOMB.=p
Se	il	PROper	PERS.=3|NOMB.=s|GENRE=n|CAS=r
n	ne	ADVneg	MORPH=empty
eſt	être	VERcjg	MODE=ind|TEMPS=pst|PERS.=3|NOMB.=s
pas	pas	ADVneg	MORPH=empty
or	or	CONcoo	MORPH=empty
tout	tout	PROind	NOMB.=s|GENRE=n
ce	ce	PROdem	NOMB.=s|GENRE=n
quon	que_on	CONsub.PROper	PERS.=3|NOMB.=s|GENRE=x|CAS=n
uoit	voire	VERcjg	MODE=ind|TEMPS=pst|PERS.=3|NOMB.=s
reluire	reluire	VERinf	MORPH=empty
Quant	quand	CONsub	MORPH=empty
le	le	DETdef	NOMB.=s|GENRE=m
ſanglier	sanglier	NOMcom	NOMB.=s|GENRE=m
eſt	être	VERcjg	MODE=ind|TEMPS=pst|PERS.=3|NOMB.=s
prins	prendre	VERppe	NOMB.=s|GENRE=m
et	et	CONcoo	MORPH=empty
mis	mettre	VERppe	NOMB.=s|GENRE=m
a	à	PRE	MORPH=empty
mort	mort	NOMcom	NOMB.=s|GENRE=f
Et	et	CONcoo	MORPH=empty
tire	tirer	VERppe	NOMB.=s|GENRE=m
hors	hors	PRE	MORPH=empty
de	de	PRE	MORPH=empty
ſon	son	DETpos	PERS.=3|NOMB.=s|GENRE=m
buiſſon	buisson	NOMcom	NOMB.=s|GENRE=m
ou	ou	CONcoo	MORPH=empty
fort	fort	NOMcom	NOMB.=s|GENRE=m
Le	le	DETdef	NOMB.=s|GENRE=m
ueneur	veneur	NOMcom	NOMB.=s|GENRE=m
doit	devoir	VERcjg	MODE=ind|TEMPS=pst|PERS.=3|NOMB.=s
prendre	prendre	VERinf	MORPH=empty
et	et	CONcoo	MORPH=empty
couper	couper	VERinf	MORPH=empty
ſa	son	DETpos	PERS.=3|NOMB.=s|GENRE=f
hure	hure	NOMcom	NOMB.=s|GENRE=f
Apres	après	PRE	MORPH=empty
de	de	PRE	MORPH=empty
oſter	ôter	VERinf	MORPH=empty
ſes	son	DETdem	PERS.=3|NOMB.=p|GENRE=f
traſſes	trace	NOMcom	NOMB.=p|GENRE=f
faire	faire	VERinf	MORPH=empty
effort	effort	NOMcom	NOMB.=s|GENRE=m
Puis	puis	PRE	MORPH=empty
ſoit	être	VERcjg	MODE=sub|TEMPS=pst|PERS.=3|NOMB.=s
fouaille	fouaille	NOMcom	NOMB.=s|GENRE=f
et	et	CONcoo	MORPH=empty
batu	battre	VERppe	NOMB.=s|GENRE=m
par	par	PRE	MORPH=empty
l	le	DETdef	NOMB.=s|GENRE=m
accord	accord	NOMcom	NOMB.=s|GENRE=m
Des	de_le	PRE.DETdef	NOMB.=p|GENRE=m
aſſiſtens	assistant	NOMcom	NOMB.=p|GENRE=m
qui	qui	PROrel	NOMB.=p|GENRE=m
le	il	PROper	PERS.=3|NOMB.=s|GENRE=m|CAS=r
prendre	prendre	VERinf	MORPH=empty
ont	avoir	VERcjg	MODE=ind|TEMPS=pst|PERS.=3|NOMB.=p
prins	prendre	VERppe	NOMB.=p|GENRE=m
cure	cure	NOMcom	NOMB.=s|GENRE=f
Oſtant	ôter	VERppa	NOMB.=p|GENRE=m
ſon	son	DETpos	PERS.=3|NOMB.=s|GENRE=m
poil	poil	NOMcom	NOMB.=s|GENRE=m
en	en	PRE	MORPH=empty
le	il	PROper	PERS.=3|NOMB.=s|GENRE=m|CAS=r
gardant	garder	VERppa	NOMB.=p|GENRE=m
d	de	PRE	MORPH=empty
ardure	ardure	NOMcom	NOMB.=s|GENRE=f
Treſ	très	ADVgen	MORPH=empty
bien	bien	ADVgen	MORPH=empty
frote	frotter	VERppe	NOMB.=s|GENRE=m
le	le	DETdef	NOMB.=s|GENRE=m
reſte	reste	NOMcom	NOMB.=s|GENRE=m
ſoit	être	VERcjg	MODE=sub|TEMPS=pst|PERS.=3|NOMB.=s
deffaict	défaire	VERppe	NOMB.=s|GENRE=m
Comme	comme	CONsub	MORPH=empty
eſt	être	VERcjg	MODE=ind|TEMPS=pst|PERS.=3|NOMB.=s
requis	requérir	VERppe	NOMB.=s|GENRE=m
,	,	PONfbl	MORPH=empty
en	en	PRE	MORPH=empty
apres	après	PRE	MORPH=empty
cela	cela	PROdem	NOMB.=s|GENRE=n
faict	faire	VERppe	NOMB.=s|GENRE=n
Droit	droit	NOMcom	NOMB.=s|GENRE=m
de	de	PRE	MORPH=empty
ueneurs	veneur	NOMcom	NOMB.=p|GENRE=m
et	et	CONcoo	MORPH=empty
de	de	PRE	MORPH=empty
chiens	chien	NOMcom	NOMB.=p|GENRE=m
conuient	convenir	VERcjg	MODE=ind|TEMPS=pst|PERS.=3|NOMB.=s
rendre	rendre	VERinf	MORPH=empty
Si	si	CONsub	MORPH=empty
le	le	DETdef	NOMB.=s|GENRE=m
ſanglier	sanglier	NOMcom	NOMB.=s|GENRE=m
par	par	PRE	MORPH=empty
ſes	son	DETdem	NOMB.=p|GENRE=f
armes	arme	NOMcom	NOMB.=p|GENRE=f
a	avoir	VERcjg	MODE=ind|TEMPS=pst|PERS.=3|NOMB.=s
faict	fait	VERppe	NOMB.=s|GENRE=m
Maulx	mal	NOMcom	NOMB.=p|GENRE=m
infiniz	infini	ADJqua	NOMB.=p|GENRE=m
ie	je	PROper	PERS.=1|NOMB.=s|GENRE=x|CAS=n
conclus	conclure	VERcjg	MODE=ind|TEMPS=pst|PERS.=1|NOMB.=s
en	en	PRE	MORPH=empty
effect	effet	NOMcom	NOMB.=s|GENRE=m
Que	que	CONsub	MORPH=empty
chaſcun	chacun	PROind	NOMB.=s|GENRE=m
ueult	vouloir	VERcjg	MODE=ind|TEMPS=pst|PERS.=3|NOMB.=s
le	le	DETdef	NOMB.=s|GENRE=m
bien	bien	NOMcom	NOMB.=s|GENRE=m
de	de	PRE	MORPH=empty
l	le	DETdef	NOMB.=s|GENRE=m
autruy	autrui	NOMcom	NOMB.=s|GENRE=m
prendre	prendre	VERinf	MORPH=empty
Raiſon	raison	NOMcom	NOMB.=s|GENRE=f
par	par	PRE	MORPH=empty
tout	tout	PROind	NOMB.=s|GENRE=n
chaſcun	chacun	PROind	NOMB.=s|GENRE=m
ne	ne	ADVneg	MORPH=empty
ueult	vouloir	VERcjg	MODE=ind|TEMPS=pst|PERS.=3|NOMB.=s
entendre	entendre	VERinf	MORPH=empty
Raiſon	raison	NOMcom	NOMB.=s|GENRE=f
par	par	PRE	MORPH=empty
tout	tout	PROind	NOMB.=s|GENRE=n
Balade	balade	NOMcom	NOMB.=s|GENRE=f
Nobleſſe	noblesse	NOMcom	NOMB.=s|GENRE=f
uoy	voir	VERcjg	MODE=ind|TEMPS=pst|PERS.=3|NOMB.=s
qui	qui	PROrel	NOMB.=s|GENRE=x
taſche	tâcher	VERcjg	MODE=ind|TEMPS=pst|PERS.=3|NOMB.=s
ſe	il	PROper	PERS.=3|NOMB.=s|GENRE=x|CAS=r
allier	allier	VERinf	MORPH=empty
Auec	avec	PRE	MORPH=empty
l	le	DETdef	NOMB.=s|GENRE=f
egliſe	église	NOMcom	NOMB.=s|GENRE=f
et	et	CONcoo	MORPH=empty
par	par	PRE	MORPH=empty
amour	amour	NOMcom	NOMB.=s|GENRE=m
lier	lier	VERinf	MORPH=empty
Pource	pour_ce	ADVgen	MORPH=empty
que	que	CONsub	MORPH=empty
peuple	peuple	NOMcom	NOMB.=s|GENRE=m
eſt	être	VERcjg	MODE=ind|TEMPS=pst|PERS.=3|NOMB.=s
deſpit	despire	VERppe	NOMB.=s|GENRE=m
et	et	CONcoo	MORPH=empty
rebelle	rebelle	ADJqua	NOMB.=s|GENRE=m
Et	et	CONcoo	MORPH=empty
ne	ne	ADVneg	MORPH=empty
ſe	il	PROper	PERS.=3|NOMB.=s|GENRE=m|CAS=r
ueult	vouloir	VERcjg	MODE=ind|TEMPS=pst|PERS.=3|NOMB.=s
a	à	PRE	MORPH=empty
droit	droit	NOMcom	NOMB.=s|GENRE=m
humilier	humilier	VERinf	MORPH=empty
N	ne	ADVneg	MORPH=empty
y	y	PROadv	MORPH=empty
a	avoir	VERcjg	MODE=ind|TEMPS=pst|PERS.=3|NOMB.=s
raiſon	raison	NOMcom	NOMB.=s|GENRE=f
,	,	PONfbl	MORPH=empty
uilles	ville	NOMcom	NOMB.=p|GENRE=f
uoy	voir	VERcjg	MODE=ind|TEMPS=pst|PERS.=3|NOMB.=s
palier	pallier	VERinf	MORPH=empty
En	en	PRE	MORPH=empty
eſcoutaut	écouter	VERppa	NOMB.=s|GENRE=x
maint	maint	DETind	NOMB.=s|GENRE=m
different	différent	ADJqua	NOMB.=s|GENRE=m
libelle	libelle	NOMcom	NOMB.=s|GENRE=m
Proueſſe	prouesse	NOMcom	NOMB.=s|GENRE=f
abruit	abruire	VERppe	NOMB.=s|GENRE=x
par	par	PRE	MORPH=empty
minerue	Minerve	NOMpro	NOMB.=s|GENRE=f
et	et	CONcoo	MORPH=empty
cibelle	Cibelles	NOMpro	NOMB.=s|GENRE=f
Sol	sol	NOMcom	NOMB.=s|GENRE=m
retrograde	rétrograde	ADJqua	NOMB.=s|GENRE=m
en	en	PRE	MORPH=empty
oſtant	ôter	VERppa	NOMB.=s|GENRE=x
ſa	son	DETpos	PERS.=3|NOMB.=s|GENRE=f
chaleur	chaleur	NOMcom	NOMB.=s|GENRE=f
Pour	pour	PRE	MORPH=empty
les	le	DETdef	NOMB.=p|GENRE=m
mutins	mutin	NOMcom	NOMB.=p|GENRE=m
tenir	tenir	VERinf	MORPH=empty
ſoubz	sous	PRE	MORPH=empty
ſa	son	DETpos	PERS.=3|NOMB.=s|GENRE=f
tutelle	tutelle	NOMcom	NOMB.=s|GENRE=f
Ιaſon	Jason	NOMpro	NOMB.=s|GENRE=m
ne	ne	ADVneg	MORPH=empty
peut	pouvoir	VERcjg	MODE=ind|TEMPS=pst|PERS.=3|NOMB.=s
refourrer	refourrer	VERinf	MORPH=empty
ſa	son	DETpos	PERS.=3|NOMB.=s|GENRE=f
cotelle	cottelle	NOMcom	NOMB.=s|GENRE=f
De	de	PRE	MORPH=empty
la	le	DETdef	NOMB.=s|GENRE=f
toiſon	toison	NOMcom	NOMB.=s|GENRE=f
dont	dont	PROrel	NOMB.=s|GENRE=f
il	il	PROper	PERS.=3|NOMB.=s|GENRE=m|CAS=n
fut	être	VERcjg	MODE=ind|TEMPS=psp|PERS.=3|NOMB.=s
conqueſteur	conquêteur	NOMcom	NOMB.=s|GENRE=m
,	,	PONfbl	MORPH=empty
Car	car	CONcoo	MORPH=empty
Charlemaigne	Charlemagne	NOMpro	NOMB.=s|GENRE=m
eſt	être	VERcjg	MODE=ind|TEMPS=pst|PERS.=3|NOMB.=s
le	le	DETdef	NOMB.=s|GENRE=m
mediateur	médiateur	NOMcom	NOMB.=s|GENRE=m
Deuers	devers	PRE	MORPH=empty
celluy	celui	PROdem	NOMB.=s|GENRE=m
que	que	PROrel	NOMB.=s|GENRE=m
nobleſſe	noblesse	NOMcom	NOMB.=s|GENRE=f
rauoye	ravoyer	VERcjg	MODE=ind|TEMPS=pst|PERS.=3|NOMB.=s
En	en	PRE	MORPH=empty
commettant	commettre	VERppa	NOMB.=s|GENRE=f
dauid	David	NOMpro	NOMB.=s|GENRE=m
royal	royal	ADJqua	NOMB.=s|GENRE=m
paſteur	pasteur	NOMcom	NOMB.=s|GENRE=m
Pour	pour	PRE	MORPH=empty
y	y	PROadv	MORPH=empty
eſlire	élire	VERinf	MORPH=empty
ung	un	DETndf	NOMB.=s|GENRE=m
nouueau	nouveau	ADJqua	NOMB.=s|GENRE=m
zelateur	zélateur	NOMcom	NOMB.=s|GENRE=m
Qui	qui	PROrel	NOMB.=s|GENRE=m
fera	faire	VERcjg	MODE=ind|TEMPS=fut|PERS.=3|NOMB.=s
cry	cri	NOMcom	NOMB.=s|GENRE=m
de	de	PRE	MORPH=empty
ſainct	saint	ADJqua	NOMB.=s|GENRE=m
Denis	Denis	NOMpro	NOMB.=s|GENRE=m
montioye	montjoie	INJ	MORPH=empty
Tout	tout	DETind	NOMB.=s|GENRE=m
bon	bon	ADJqua	NOMB.=s|GENRE=m
uouloir	vouloir	NOMcom	NOMB.=s|GENRE=m
dieu	dieu	NOMcom	NOMB.=s|GENRE=m
cõduit	conduit	VERcjg	MODE=ind|TEMPS=pst|PERS.=3|NOMB.=s
et	et	CONcoo	MORPH=empty
pouruoye	pourvoir	VERcjg	MODE=ind|TEMPS=pst|PERS.=3|NOMB.=s
Sanxon	Sanson	NOMpro	NOMB.=s|GENRE=m
le	le	DETdef	NOMB.=s|GENRE=m
fort	fort	NOMcom	NOMB.=s|GENRE=m
ſera	être	VERcjg	MODE=ind|TEMPS=fut|PERS.=3|NOMB.=s
le	le	DETdef	NOMB.=s|GENRE=m
uray	vrai	ADJqua	NOMB.=s|GENRE=m
ducteur	ducteur	NOMcom	NOMB.=s|GENRE=m
Melchiſedech	Melchisedech	NOMpro	NOMB.=s|GENRE=m
de	de	PRE	MORPH=empty
biens	bien	NOMcom	NOMB.=p|GENRE=m
miniſtrateur	ministrateur	NOMcom	NOMB.=s|GENRE=m
Le	le	DETdef	NOMB.=s|GENRE=m
bon	bon	ADJqua	NOMB.=s|GENRE=m
Iacob	Jacob	NOMpro	NOMB.=s|GENRE=m
ſes	son	DETpos	PERS.=3|NOMB.=p|GENRE=f
ouailles	ouaille	NOMcom	NOMB.=p|GENRE=f
y	y	PROadv	MORPH=empty
employe	employer	VERcjg	MODE=ind|TEMPS=pst|PERS.=3|NOMB.=s
Auſſi	aussi	ADVgen	MORPH=empty
Noe	Noé	NOMpro	NOMB.=s|GENRE=m
de	de	PRE	MORPH=empty
la	le	DETdef	NOMB.=s|GENRE=f
uigne	vigne	NOMcom	NOMB.=s|GENRE=f
planteur	planteur	NOMcom	NOMB.=s|GENRE=m
De	de	PRE	MORPH=empty
ſa	son	DETpos	PERS.=3|NOMB.=s|GENRE=f
liqueur	liqueur	NOMcom	NOMB.=s|GENRE=f
uerrons	voir	VERcjg	MODE=ind|TEMPS=fut|PERS.=1|NOMB.=p
augmentateur	augmentateur	NOMcom	NOMB.=s|GENRE=m
Se	si	CONsub	MORPH=empty
iuſte	juste	ADJqua	NOMB.=s|GENRE=m
droit	droit	NOMcom	NOMB.=s|GENRE=m
ſon	son	DETpos	PERS.=3|NOMB.=s|GENRE=m
eſtendard	étendard	NOMcom	NOMB.=s|GENRE=m
deſploye	déployer	VERcjg	MODE=sub|TEMPS=pst|PERS.=3|NOMB.=s
Tout	tout	DETind	NOMB.=s|GENRE=m
bõ	bon	ADJqua	NOMB.=s|GENRE=m
uouloir	vouloir	NOMcom	NOMB.=s|GENRE=m
dieu	dieu	NOMcom	NOMB.=s|GENRE=m
conduit	conduit	VERcjg	MODE=ind|TEMPS=pst|PERS.=3|NOMB.=s
et	et	CONcoo	MORPH=empty
pouruoye	pourvoir	VERcjg	MODE=ind|TEMPS=pst|PERS.=3|NOMB.=s
Raison	raison	NOMcom	NOMB.=s|GENRE=f
par	par	PRE	MORPH=empty
tout	tout	PROind	NOMB.=s|GENRE=n
L	le	DETdef	NOMB.=s|GENRE=m
acteur	acteur	NOMcom	NOMB.=s|GENRE=m
Triſte	triste	ADJqua	NOMB.=s|GENRE=x
et	et	CONcoo	MORPH=empty
penſif	pensif	ADJqua	NOMB.=s|GENRE=x
aggraue	aggraver	VERppe	NOMB.=s|GENRE=x
de	de	PRE	MORPH=empty
ſoucy	souci	NOMcom	NOMB.=s|GENRE=m
En	en	PRE	MORPH=empty
repoſant	reposer	VERppa	NOMB.=s|GENRE=x
et	et	CONcoo	MORPH=empty
dormant	dormir	VERppa	NOMB.=s|GENRE=x
a	à	PRE	MORPH=empty
Nancy	Nancy	NOMpro	NOMB.=s|GENRE=x
Ap̃s	après	PRE	MORPH=empty
que	que	CONsub	MORPH=empty
ie	je	PROper	PERS.=1|NOMB.=s|GENRE=x|CAS=n
euz	avoir	VERcjg	MODE=ind|TEMPS=pst|PERS.=1|NOMB.=s
contemple	contempler	VERppe	NOMB.=s|GENRE=x
quelque	quelque	DETind	NOMB.=s|GENRE=f
hiſtoire	histoire	NOMcom	NOMB.=s|GENRE=f
Me	je	PROper	PERS.=1|NOMB.=s|GENRE=x|CAS=r
fut	être	VERcjg	MODE=ind|TEMPS=psp|PERS.=3|NOMB.=s
aduis	aviser	VERppe	NOMB.=s|GENRE=x
que	que	CONsub	MORPH=empty
en	en	PRE	MORPH=empty
ung	un	DETndf	NOMB.=s|GENRE=m
ſonge	songe	NOMcom	NOMB.=s|GENRE=m
tranſy	transir	VERppe	NOMB.=s|GENRE=x
Ie	je	PROper	PERS.=1|NOMB.=s|GENRE=x|CAS=n
ueiz	voir	VERcjg	MODE=ind|TEMPS=pst|PERS.=1|NOMB.=s
Dauid	David	NOMpro	NOMB.=s|GENRE=m
qui	qui	PROrel	NOMB.=s|GENRE=m
me	je	PROper	PERS.=1|NOMB.=s|GENRE=m|CAS=r
dit	dire	VERcjg	MODE=ind|TEMPS=pst|PERS.=3|NOMB.=s
ces	ce	DETdem	NOMB.=p|GENRE=m
motz	mot	NOMcom	NOMB.=p|GENRE=m
cy	ci	ADVgen	MORPH=empty
Lieue	lever	VERcjg	MODE=imp|PERS.=2|NOMB.=s
toy	tu	PROper	PERS.=2|NOMB.=s|GENRE=x|CAS=r
ſus	sus	PRE	MORPH=empty
herault	héraut	NOMcom	NOMB.=s|GENRE=m
d	de	PRE	MORPH=empty
armes	arme	NOMcom	NOMB.=p|GENRE=f
Gringoire	Gringoire	NOMpro	NOMB.=s|GENRE=m
Prens	prendre	VERcjg	MODE=imp|NOMB.=s|PERS.=2
ton	ton	DETpos	PERS.=2|NOMB.=s|GENRE=m
papier	papier	NOMcom	NOMB.=s|GENRE=m
ta	ton	DETpos	PERS.=2|NOMB.=s|GENRE=f
plume	plume	NOMcom	NOMB.=s|GENRE=f
et	et	CONcoo	MORPH=empty
eſcriptoire	écritoire	NOMcom	NOMB.=s|GENRE=m
Metz	mettre	VERcjg	MODE=imp|NOMB.=s|PERS.=2
par	par	PRE	MORPH=empty
eſcript	écrit	NOMcom	NOMB.=s|GENRE=m
ce	ce	DETdem	NOMB.=s|GENRE=m
beau	beau	ADJqua	NOMB.=s|GENRE=m
pſeaulme	psaume	NOMcom	NOMB.=s|GENRE=m
icy	ici	ADVgen	MORPH=empty
Que	que	PROrel	NOMB.=s|GENRE=m
feis	faire	VERcjg	MODE=ind|TEMPS=x|PERS.=1|NOMB.=s
ung	un	DETndf	NOMB.=s|GENRE=m
iour	jour	NOMcom	NOMB.=s|GENRE=m
pour	pour	PRE	MORPH=empty
le	le	DETdef	NOMB.=s|GENRE=m
triumphe	triomphe	NOMcom	NOMB.=s|GENRE=m
et	et	CONcoo	MORPH=empty
gloire	gloire	NOMcom	NOMB.=s|GENRE=f
Du	de_le	PRE.DETdef	NOMB.=s|GENRE=m
roy	roi	NOMcom	NOMB.=s|GENRE=m
Francois	François	NOMpro	NOMB.=s|GENRE=m
qui	qui	PROrel	NOMB.=s|GENRE=m
obtiendra	obtenir	VERcjg	MODE=ind|TEMPS=fut|PERS.=3|NOMB.=s
uictoire	victoire	NOMcom	NOMB.=s|GENRE=f
Sil	si_il	CONsub.PROper	PERS.=3|NOMB.=s|GENRE=m|CAS=n
ſe	il	PROper	PERS.=3|NOMB.=s|GENRE=m|CAS=r
ſubmet	soumettre	VERcjg	MODE=ind|TEMPS=pst|PERS.=3|NOMB.=s
ſoubz	sous	PRE	MORPH=empty
diuine	divin	ADJqua	NOMB.=s|GENRE=f
mercy	merci	NOMcom	NOMB.=s|GENRE=f
Ioyeulx	joyeux	ADJqua	NOMB.=s|GENRE=m
reſueil	réveil	NOMcom	NOMB.=s|GENRE=m
faict	faire	VERcjg	MODE=ind|TEMPS=pst|PERS.=3|NOMB.=s
le	le	DETdef	NOMB.=s|GENRE=m
cueur	cœur	NOMcom	NOMB.=s|GENRE=m
eſclarcy	éclaircir	VERppe	NOMB.=s|GENRE=m
Menus	menu	ADJqua	NOMB.=p|GENRE=m
ꝓpos	propos	NOMcom	NOMB.=p|GENRE=m
ſur	sur	PRE	MORPH=empty
le	le	DETdef	NOMB.=s|GENRE=m
pſeaulme	psaume	NOMcom	NOMB.=s|GENRE=m
Benedictus	@latin	OUT	MORPH=empty
dominus	@latin	OUT	MORPH=empty
deus	@latin	OUT	MORPH=empty
meus	@latin	OUT	MORPH=empty
qui	@latin	OUT	MORPH=empty
docet	@latin	OUT	MORPH=empty
manus	@latin	OUT	MORPH=empty
meas	@latin	OUT	MORPH=empty
ad	@latin	OUT	MORPH=empty
prelium	@latin	OUT	MORPH=empty
:	:	PONfbl	MORPH=empty
et	@latin	OUT	MORPH=empty
digitos	@latin	OUT	MORPH=empty
meos	@latin	OUT	MORPH=empty
ad	@latin	OUT	MORPH=empty
bellum	@latin	OUT	MORPH=empty
BEenoiſtz	benoît	ADJqua	NOMB.=p|GENRE=m
ſont	être	VERcjg	MODE=ind|TEMPS=pst|PERS.=3|NOMB.=p
ceulx	celui	PROdem	NOMB.=p|GENRE=m
qui	qui	PROrel	NOMB.=p|GENRE=m
ueullẽt	vouloir	VERcjg	MODE=ind|TEMPS=pst|PERS.=3|NOMB.=p
dominer	dominer	VERinf	MORPH=empty
Gardans	garder	VERppa	NOMB.=p|GENRE=m
la	le	DETdef	NOMB.=s|GENRE=f
loy	loi	NOMcom	NOMB.=s|GENRE=f
cuidant	cuider	VERppa	NOMB.=p|GENRE=m
faire	faire	VERinf	MORPH=empty
regner	régner	VERinf	MORPH=empty
Amour	amour	NOMcom	NOMB.=s|GENRE=m
et	et	CONcoo	MORPH=empty
paix	paix	NOMcom	NOMB.=s|GENRE=f
en	en	PRE	MORPH=empty
augmentant	augmenter	VERppa	NOMB.=p|GENRE=m
iuſtice	justice	NOMcom	NOMB.=s|GENRE=f
Beinoiſtz	benoît	ADJqua	NOMB.=p|GENRE=m
ſont	être	VERcjg	MODE=ind|TEMPS=pst|PERS.=3|NOMB.=p
ceulx	celui	PROdem	NOMB.=p|GENRE=m
a	à	PRE	MORPH=empty
qui	qui	PROrel	NOMB.=p|GENRE=m
dieu	dieu	NOMcom	NOMB.=s|GENRE=m
ueult	vouloir	VERcjg	MODE=ind|TEMPS=pst|PERS.=3|NOMB.=s
donner	donner	VERinf	MORPH=empty
Les	le	DETdef	NOMB.=p|GENRE=f
mains	main	NOMcom	NOMB.=p|GENRE=f
et	et	CONcoo	MORPH=empty
doigz	doigt	NOMcom	NOMB.=p|GENRE=m
pour	pour	PRE	MORPH=empty
bataille	bataille	NOMcom	NOMB.=s|GENRE=f
ordonner	ordonner	VERinf	MORPH=empty
Et	et	CONcoo	MORPH=empty
corriger	corriger	VERinf	MORPH=empty
gens	gens	NOMcom	NOMB.=p|GENRE=m
remplis	remplir	VERppe	NOMB.=p|GENRE=m
de	de	PRE	MORPH=empty
malice	malice	NOMcom	NOMB.=s|GENRE=f
Affin	afin	ADVgen	MORPH=empty
que	que	CONsub	MORPH=empty
de	de	PRE	MORPH=empty
eulx	il	PROper	PERS.=3|NOMB.=p|GENRE=m|CAS=i
l	le	DETdef	NOMB.=s|GENRE=f
erreur	erreur	NOMcom	NOMB.=s|GENRE=f
et	et	CONcoo	MORPH=empty
le	le	DETdef	NOMB.=s|GENRE=m
malyſſe	malice	NOMcom	NOMB.=s|GENRE=m
Qui	qui	PROrel	NOMB.=s|GENRE=x
en	en	PRE	MORPH=empty
peche	péché	NOMcom	NOMB.=s|GENRE=m
les	il	PROper	PERS.=3|NOMB.=p|GENRE=m|CAS=r
contrainct	contraindre	VERcjg	MODE=ind|TEMPS=pst|PERS.=3|NOMB.=s
cheminer	cheminer	VERinf	MORPH=empty
Dont	dont	PROrel	NOMB.=s|GENRE=n
toy	tu	PROper	PERS.=2|NOMB.=s|GENRE=x|CAS=n
ſeulas	seul	ADJqua	NOMB.=s|GENRE=x
as	avoir	VERcjg	MODE=ind|TEMPS=pst|PERS.=2|NOMB.=s
congnoiſſance	connaissance	NOMcom	NOMB.=s|GENRE=f
et	et	CONcoo	MORPH=empty
notice	notice	NOMcom	NOMB.=s|GENRE=f
Mon	mon	DETpos	PERS.=1|NOMB.=s|GENRE=m
dieu	dieu	NOMcom	NOMB.=s|GENRE=m
permetz	permettre	VERcjg	MODE=imp|PERS.=2|NOMB.=s
que	que	CONsub	MORPH=empty
ta	ton	DETpos	PERS.=2|NOMB.=s|GENRE=f
foy	foi	NOMcom	NOMB.=s|GENRE=f
ie	je	PROper	PERS.=1|NOMB.=s|GENRE=x|CAS=n
accompliſſes	accomplir	VERcjg	MODE=sub|TEMPS=pst|PERS.=1|NOMB.=s
Sans	sans	PRE	MORPH=empty
contre	contre	PRE	MORPH=empty
moy	je	PROper	PERS.=1|NOMB.=s|GENRE=x|CAS=i
par	par	PRE	MORPH=empty
courroux	courroux	NOMcom	NOMB.=s|GENRE=m
te	tu	PROper	PERS.=2|NOMB.=s|GENRE=x|CAS=r
indigner	indigner	VERinf	MORPH=empty
Selon	selon	PRE	MORPH=empty
raiſon	raison	NOMcom	NOMB.=s|GENRE=f
on	on	PROper	PERS.=3|NOMB.=s|GENRE=x|CAS=n
doit	devoir	VERcjg	MODE=ind|TEMPS=pst|PERS.=3|NOMB.=s
ſon	son	DETpos	PERS.=3|NOMB.=s|GENRE=m
train	train	NOMcom	NOMB.=s|GENRE=m
mener	mener	VERinf	MORPH=empty
O	ô	INJ	MORPH=empty
monſeigneur	monseigneur	NOMcom	NOMB.=s|GENRE=m
quant	quand	CONsub	MORPH=empty
tes	ton	DETpos	PERS.=2|NOMB.=p|GENRE=m
faictz	fait	NOMcom	NOMB.=p|GENRE=m
ie	je	PROper	PERS.=1|NOMB.=s|GENRE=x|CAS=n
recorde	recorder	VERcjg	MODE=ind|TEMPS=pst|PERS.=1|NOMB.=s
Mon	mon	DETpos	PERS.=1|NOMB.=s|GENRE=m
refuge	refuge	NOMcom	NOMB.=s|GENRE=m
es	être	VERcjg	MODE=ind|TEMPS=pst|PERS.=2|NOMB.=s
et	et	CONcoo	MORPH=empty
ma	mon	DETpos	PERS.=1|NOMB.=s|GENRE=f
miſericorde	miséricorde	NOMcom	NOMB.=s|GENRE=f
Tout	tout	DETind	NOMB.=s|GENRE=m
mon	mon	ADJpos	PERS.=1|NOMB.=s|GENRE=m
ſalut	salut	NOMcom	NOMB.=s|GENRE=m
,	,	PONfbl	MORPH=empty
mon	mon	DETpos	PERS.=1|NOMB.=s|GENRE=m
bien	bien	NOMcom	NOMB.=s|GENRE=m
et	et	CONcoo	MORPH=empty
ſuſcepteur	suscepteur	NOMcom	NOMB.=s|GENRE=m
Qui	qui	PROrel	NOMB.=s|GENRE=m
hais	haïr	VERcjg	MODE=ind|TEMPS=pst|PERS.=2|NOMB.=s
orgueil	orgueil	NOMcom	NOMB.=s|GENRE=m
deſpiteuſe	dépiteux	ADJqua	NOMB.=s|GENRE=f
diſcorde	discorde	NOMcom	NOMB.=s|GENRE=f
Mettant	mettre	VERppa	NOMB.=s|GENRE=x
en	en	PRE	MORPH=empty
bruit	bruit	NOMcom	NOMB.=s|GENRE=m
aimable	aimable	ADJqua	NOMB.=s|GENRE=f
concorde	concorde	NOMcom	NOMB.=s|GENRE=f
